"year","week","zone","spp","mosq_L","mosq_G","mosq","trap_L","abund"
2014,30,"FC","Pipiens",621,269,890,53,11.72
2014,30,"FC","Tarsalis",7783,4,7787,53,146.85
2014,30,"LV","Pipiens",57,0,57,10,5.7
2014,30,"LV","Tarsalis",1255,0,1255,10,125.5
2014,30,"NE","Pipiens",189,7,196,10,18.9
2014,30,"NE","Tarsalis",2196,2,2198,10,219.6
2014,30,"NW","Pipiens",64,67,131,9,7.11
2014,30,"NW","Tarsalis",824,0,824,9,91.56
2014,30,"SE","Pipiens",287,94,381,15,19.13
2014,30,"SE","Tarsalis",3077,1,3078,15,205.13
2014,30,"SW","Pipiens",24,101,125,9,2.67
2014,30,"SW","Tarsalis",431,1,432,9,47.89
2015,24,"FC","Pipiens",35,141,176,49,0.71
2015,24,"FC","Tarsalis",324,0,324,49,6.61
2015,24,"LV","Pipiens",0,0,0,6,0
2015,24,"LV","Tarsalis",68,0,68,6,11.33
2015,24,"NE","Pipiens",10,16,26,10,1
2015,24,"NE","Tarsalis",121,0,121,10,12.1
2015,24,"NW","Pipiens",8,4,12,9,0.89
2015,24,"NW","Tarsalis",19,0,19,9,2.11
2015,24,"SE","Pipiens",5,113,118,15,0.33
2015,24,"SE","Tarsalis",78,0,78,15,5.2
2015,24,"SW","Pipiens",12,8,20,9,1.33
2015,24,"SW","Tarsalis",38,0,38,9,4.22
2015,25,"FC","Pipiens",65,146,211,49,1.33
2015,25,"FC","Tarsalis",3447,2,3449,49,70.35
2015,25,"LV","Pipiens",0,0,0,6,0
2015,25,"LV","Tarsalis",1482,0,1482,6,247
2015,25,"NE","Pipiens",36,41,77,10,3.6
2015,25,"NE","Tarsalis",577,1,578,10,57.7
2015,25,"NW","Pipiens",8,15,23,9,0.89
2015,25,"NW","Tarsalis",192,0,192,9,21.33
2015,25,"SE","Pipiens",16,84,100,15,1.07
2015,25,"SE","Tarsalis",1039,1,1040,15,69.27
2015,25,"SW","Pipiens",5,6,11,9,0.56
2015,25,"SW","Tarsalis",157,0,157,9,17.44
2015,26,"FC","Pipiens",118,414,532,49,2.41
2015,26,"FC","Tarsalis",2749,24,2773,49,56.1
2015,26,"LV","Pipiens",14,0,14,6,2.33
2015,26,"LV","Tarsalis",587,0,587,6,97.83
2015,26,"NE","Pipiens",20,108,128,10,2
2015,26,"NE","Tarsalis",776,24,800,10,77.6
2015,26,"NW","Pipiens",25,24,49,9,2.78
2015,26,"NW","Tarsalis",290,0,290,9,32.22
2015,26,"SE","Pipiens",52,265,317,15,3.47
2015,26,"SE","Tarsalis",1006,0,1006,15,67.07
2015,26,"SW","Pipiens",7,17,24,9,0.78
2015,26,"SW","Tarsalis",90,0,90,9,10
2015,27,"FC","Pipiens",206,292,498,49,4.2
2015,27,"FC","Tarsalis",2621,1,2622,49,53.49
2015,27,"LV","Pipiens",15,0,15,6,2.5
2015,27,"LV","Tarsalis",1224,0,1224,6,204
2015,27,"NE","Pipiens",92,55,147,10,9.2
2015,27,"NE","Tarsalis",482,0,482,10,48.2
2015,27,"NW","Pipiens",51,7,58,9,5.67
2015,27,"NW","Tarsalis",107,0,107,9,11.89
2015,27,"SE","Pipiens",38,207,245,15,2.53
2015,27,"SE","Tarsalis",747,1,748,15,49.8
2015,27,"SW","Pipiens",10,23,33,9,1.11
2015,27,"SW","Tarsalis",61,0,61,9,6.78
2015,28,"FC","Pipiens",312,562,874,49,6.37
2015,28,"FC","Tarsalis",4711,3,4714,49,96.14
2015,28,"LV","Pipiens",24,0,24,6,4
2015,28,"LV","Tarsalis",1370,0,1370,6,228.33
2015,28,"NE","Pipiens",84,319,403,10,8.4
2015,28,"NE","Tarsalis",1137,0,1137,10,113.7
2015,28,"NW","Pipiens",68,71,139,9,7.56
2015,28,"NW","Tarsalis",235,2,237,9,26.11
2015,28,"SE","Pipiens",113,145,258,15,7.53
2015,28,"SE","Tarsalis",1886,1,1887,15,125.73
2015,28,"SW","Pipiens",23,27,50,9,2.56
2015,28,"SW","Tarsalis",83,0,83,9,9.22
2015,29,"FC","Pipiens",426,695,1121,49,8.69
2015,29,"FC","Tarsalis",4387,16,4403,49,89.53
2015,29,"LV","Pipiens",30,0,30,6,5
2015,29,"LV","Tarsalis",1089,0,1089,6,181.5
2015,29,"NE","Pipiens",95,363,458,10,9.5
2015,29,"NE","Tarsalis",918,9,927,10,91.8
2015,29,"NW","Pipiens",103,30,133,9,11.44
2015,29,"NW","Tarsalis",413,0,413,9,45.89
2015,29,"SE","Pipiens",149,266,415,15,9.93
2015,29,"SE","Tarsalis",1623,7,1630,15,108.2
2015,29,"SW","Pipiens",49,36,85,9,5.44
2015,29,"SW","Tarsalis",344,0,344,9,38.22
2015,30,"FC","Pipiens",498,661,1159,49,10.16
2015,30,"FC","Tarsalis",6102,14,6116,49,124.53
2015,30,"LV","Pipiens",15,0,15,6,2.5
2015,30,"LV","Tarsalis",1303,0,1303,6,217.17
2015,30,"NE","Pipiens",130,199,329,10,13
2015,30,"NE","Tarsalis",1780,6,1786,10,178
2015,30,"NW","Pipiens",105,68,173,9,11.67
2015,30,"NW","Tarsalis",680,1,681,9,75.56
2015,30,"SE","Pipiens",210,350,560,15,14
2015,30,"SE","Tarsalis",2012,7,2019,15,134.13
2015,30,"SW","Pipiens",38,44,82,9,4.22
2015,30,"SW","Tarsalis",327,0,327,9,36.33
2015,31,"FC","Pipiens",480,692,1172,49,9.8
2015,31,"FC","Tarsalis",3321,6,3327,49,67.78
2015,31,"LV","Pipiens",15,0,15,6,2.5
2015,31,"LV","Tarsalis",499,0,499,6,83.17
2015,31,"NE","Pipiens",163,428,591,10,16.3
2015,31,"NE","Tarsalis",1388,2,1390,10,138.8
2015,31,"NW","Pipiens",93,123,216,9,10.33
2015,31,"NW","Tarsalis",416,1,417,9,46.22
2015,31,"SE","Pipiens",142,91,233,15,9.47
2015,31,"SE","Tarsalis",740,2,742,15,49.33
2015,31,"SW","Pipiens",67,50,117,9,7.44
2015,31,"SW","Tarsalis",278,1,279,9,30.89
2015,32,"FC","Pipiens",391,435,826,49,7.98
2015,32,"FC","Tarsalis",1453,3,1456,49,29.65
2015,32,"LV","Pipiens",22,0,22,6,3.67
2015,32,"LV","Tarsalis",234,0,234,6,39
2015,32,"NE","Pipiens",114,127,241,10,11.4
2015,32,"NE","Tarsalis",569,3,572,10,56.9
2015,32,"NW","Pipiens",102,136,238,9,11.33
2015,32,"NW","Tarsalis",279,0,279,9,31
2015,32,"SE","Pipiens",146,172,318,15,9.73
2015,32,"SE","Tarsalis",340,0,340,15,22.67
2015,32,"SW","Pipiens",7,0,7,9,0.78
2015,32,"SW","Tarsalis",31,0,31,9,3.44
2015,33,"FC","Pipiens",341,686,1027,49,6.96
2015,33,"FC","Tarsalis",389,1,390,49,7.94
2015,33,"LV","Pipiens",23,0,23,6,3.83
2015,33,"LV","Tarsalis",76,0,76,6,12.67
2015,33,"NE","Pipiens",141,348,489,10,14.1
2015,33,"NE","Tarsalis",127,1,128,10,12.7
2015,33,"NW","Pipiens",42,11,53,9,4.67
2015,33,"NW","Tarsalis",30,0,30,9,3.33
2015,33,"SE","Pipiens",111,292,403,15,7.4
2015,33,"SE","Tarsalis",132,0,132,15,8.8
2015,33,"SW","Pipiens",24,35,59,9,2.67
2015,33,"SW","Tarsalis",24,0,24,9,2.67
2015,34,"FC","Pipiens",413,1391,1804,49,8.43
2015,34,"FC","Tarsalis",554,3,557,49,11.31
2015,34,"LV","Pipiens",37,0,37,6,6.17
2015,34,"LV","Tarsalis",146,0,146,6,24.33
2015,34,"NE","Pipiens",101,134,235,10,10.1
2015,34,"NE","Tarsalis",72,0,72,10,7.2
2015,34,"NW","Pipiens",53,485,538,9,5.89
2015,34,"NW","Tarsalis",95,1,96,9,10.56
2015,34,"SE","Pipiens",189,685,874,15,12.6
2015,34,"SE","Tarsalis",162,2,164,15,10.8
2015,34,"SW","Pipiens",33,87,120,9,3.67
2015,34,"SW","Tarsalis",79,0,79,9,8.78
2015,35,"FC","Pipiens",369,807,1176,49,7.53
2015,35,"FC","Tarsalis",370,0,370,49,7.55
2015,35,"LV","Pipiens",4,0,4,6,0.67
2015,35,"LV","Tarsalis",118,0,118,6,19.67
2015,35,"NE","Pipiens",141,257,398,10,14.1
2015,35,"NE","Tarsalis",113,0,113,10,11.3
2015,35,"NW","Pipiens",26,130,156,9,2.89
2015,35,"NW","Tarsalis",22,0,22,9,2.44
2015,35,"SE","Pipiens",187,271,458,15,12.47
2015,35,"SE","Tarsalis",72,0,72,15,4.8
2015,35,"SW","Pipiens",11,149,160,9,1.22
2015,35,"SW","Tarsalis",45,0,45,9,5
2015,37,"FC","Pipiens",218,276,494,43,5.07
2015,37,"FC","Tarsalis",40,1,41,43,0.93
2015,37,"NE","Pipiens",92,102,194,10,9.2
2015,37,"NE","Tarsalis",16,1,17,10,1.6
2015,37,"NW","Pipiens",18,17,35,9,2
2015,37,"NW","Tarsalis",12,0,12,9,1.33
2015,37,"SE","Pipiens",108,152,260,15,7.2
2015,37,"SE","Tarsalis",4,0,4,15,0.27
2015,37,"SW","Pipiens",0,5,5,9,0
2015,37,"SW","Tarsalis",8,0,8,9,0.89
2016,24,"FC","Pipiens",25,70,95,49,0.51
2016,24,"FC","Tarsalis",82,1,83,49,1.67
2016,24,"LV","Pipiens",4,0,4,6,0.67
2016,24,"LV","Tarsalis",43,0,43,6,7.17
2016,24,"NE","Pipiens",4,31,35,10,0.4
2016,24,"NE","Tarsalis",15,1,16,10,1.5
2016,24,"NW","Pipiens",7,1,8,9,0.78
2016,24,"NW","Tarsalis",3,0,3,9,0.33
2016,24,"SE","Pipiens",8,29,37,15,0.53
2016,24,"SE","Tarsalis",19,0,19,15,1.27
2016,24,"SW","Pipiens",2,9,11,9,0.22
2016,24,"SW","Tarsalis",2,0,2,9,0.22
2016,25,"FC","Pipiens",57,135,192,49,1.16
2016,25,"FC","Tarsalis",579,1,580,49,11.82
2016,25,"LV","Pipiens",2,0,2,6,0.33
2016,25,"LV","Tarsalis",316,0,316,6,52.67
2016,25,"NE","Pipiens",32,48,80,10,3.2
2016,25,"NE","Tarsalis",98,0,98,10,9.8
2016,25,"NW","Pipiens",8,13,21,9,0.89
2016,25,"NW","Tarsalis",17,1,18,9,1.89
2016,25,"SE","Pipiens",10,51,61,15,0.67
2016,25,"SE","Tarsalis",128,0,128,15,8.53
2016,25,"SW","Pipiens",5,23,28,9,0.56
2016,25,"SW","Tarsalis",20,0,20,9,2.22
2016,26,"FC","Pipiens",128,254,382,49,2.61
2016,26,"FC","Tarsalis",949,2,951,49,19.37
2016,26,"LV","Pipiens",3,0,3,6,0.5
2016,26,"LV","Tarsalis",369,0,369,6,61.5
2016,26,"NE","Pipiens",53,122,175,10,5.3
2016,26,"NE","Tarsalis",145,1,146,10,14.5
2016,26,"NW","Pipiens",22,16,38,9,2.44
2016,26,"NW","Tarsalis",38,0,38,9,4.22
2016,26,"SE","Pipiens",39,100,139,15,2.6
2016,26,"SE","Tarsalis",367,1,368,15,24.47
2016,26,"SW","Pipiens",11,16,27,9,1.22
2016,26,"SW","Tarsalis",30,0,30,9,3.33
2016,27,"FC","Pipiens",280,389,669,49,5.71
2016,27,"FC","Tarsalis",960,0,960,49,19.59
2016,27,"LV","Pipiens",17,0,17,6,2.83
2016,27,"LV","Tarsalis",177,0,177,6,29.5
2016,27,"NE","Pipiens",100,91,191,10,10
2016,27,"NE","Tarsalis",163,0,163,10,16.3
2016,27,"NW","Pipiens",65,182,247,9,7.22
2016,27,"NW","Tarsalis",47,0,47,9,5.22
2016,27,"SE","Pipiens",86,116,202,15,5.73
2016,27,"SE","Tarsalis",569,0,569,15,37.93
2016,27,"SW","Pipiens",12,0,12,9,1.33
2016,27,"SW","Tarsalis",4,0,4,9,0.44
2016,28,"FC","Pipiens",307,416,723,49,6.27
2016,28,"FC","Tarsalis",2124,8,2132,49,43.35
2016,28,"LV","Pipiens",10,0,10,6,1.67
2016,28,"LV","Tarsalis",465,0,465,6,77.5
2016,28,"NE","Pipiens",88,125,213,10,8.8
2016,28,"NE","Tarsalis",579,7,586,10,57.9
2016,28,"NW","Pipiens",132,119,251,9,14.67
2016,28,"NW","Tarsalis",340,0,340,9,37.78
2016,28,"SE","Pipiens",48,105,153,15,3.2
2016,28,"SE","Tarsalis",663,0,663,15,44.2
2016,28,"SW","Pipiens",29,67,96,9,3.22
2016,28,"SW","Tarsalis",77,1,78,9,8.56
2016,29,"FC","Pipiens",329,872,1201,49,6.71
2016,29,"FC","Tarsalis",1657,2,1659,49,33.82
2016,29,"LV","Pipiens",15,0,15,6,2.5
2016,29,"LV","Tarsalis",376,0,376,6,62.67
2016,29,"NE","Pipiens",151,202,353,10,15.1
2016,29,"NE","Tarsalis",537,2,539,10,53.7
2016,29,"NW","Pipiens",106,46,152,9,11.78
2016,29,"NW","Tarsalis",310,0,310,9,34.44
2016,29,"SE","Pipiens",43,170,213,15,2.87
2016,29,"SE","Tarsalis",306,0,306,15,20.4
2016,29,"SW","Pipiens",14,454,468,9,1.56
2016,29,"SW","Tarsalis",128,0,128,9,14.22
2016,30,"FC","Pipiens",422,648,1070,49,8.61
2016,30,"FC","Tarsalis",2130,2,2132,49,43.47
2016,30,"LV","Pipiens",19,0,19,6,3.17
2016,30,"LV","Tarsalis",569,0,569,6,94.83
2016,30,"NE","Pipiens",136,155,291,10,13.6
2016,30,"NE","Tarsalis",430,0,430,10,43
2016,30,"NW","Pipiens",170,220,390,9,18.89
2016,30,"NW","Tarsalis",248,0,248,9,27.56
2016,30,"SE","Pipiens",73,211,284,15,4.87
2016,30,"SE","Tarsalis",725,2,727,15,48.33
2016,30,"SW","Pipiens",24,62,86,9,2.67
2016,30,"SW","Tarsalis",158,0,158,9,17.56
2016,31,"FC","Pipiens",607,496,1103,49,12.39
2016,31,"FC","Tarsalis",1998,4,2002,49,40.78
2016,31,"LV","Pipiens",23,0,23,6,3.83
2016,31,"LV","Tarsalis",355,0,355,6,59.17
2016,31,"NE","Pipiens",245,133,378,10,24.5
2016,31,"NE","Tarsalis",345,1,346,10,34.5
2016,31,"NW","Pipiens",199,29,228,9,22.11
2016,31,"NW","Tarsalis",324,0,324,9,36
2016,31,"SE","Pipiens",110,221,331,15,7.33
2016,31,"SE","Tarsalis",767,2,769,15,51.13
2016,31,"SW","Pipiens",30,113,143,9,3.33
2016,31,"SW","Tarsalis",207,1,208,9,23
2016,32,"FC","Pipiens",757,543,1300,49,15.45
2016,32,"FC","Tarsalis",1908,7,1915,49,38.94
2016,32,"LV","Pipiens",19,0,19,6,3.17
2016,32,"LV","Tarsalis",414,0,414,6,69
2016,32,"NE","Pipiens",321,47,368,10,32.1
2016,32,"NE","Tarsalis",634,1,635,10,63.4
2016,32,"NW","Pipiens",290,138,428,9,32.22
2016,32,"NW","Tarsalis",226,1,227,9,25.11
2016,32,"SE","Pipiens",95,257,352,15,6.33
2016,32,"SE","Tarsalis",495,3,498,15,33
2016,32,"SW","Pipiens",32,101,133,9,3.56
2016,32,"SW","Tarsalis",139,2,141,9,15.44
2016,33,"FC","Pipiens",778,719,1497,49,15.88
2016,33,"FC","Tarsalis",1493,4,1497,49,30.47
2016,33,"LV","Pipiens",16,0,16,6,2.67
2016,33,"LV","Tarsalis",289,0,289,6,48.17
2016,33,"NE","Pipiens",425,449,874,10,42.5
2016,33,"NE","Tarsalis",516,4,520,10,51.6
2016,33,"NW","Pipiens",221,77,298,9,24.56
2016,33,"NW","Tarsalis",209,0,209,9,23.22
2016,33,"SE","Pipiens",96,147,243,15,6.4
2016,33,"SE","Tarsalis",394,0,394,15,26.27
2016,33,"SW","Pipiens",20,46,66,9,2.22
2016,33,"SW","Tarsalis",85,0,85,9,9.44
2016,34,"FC","Pipiens",218,804,1022,51,4.27
2016,34,"FC","Tarsalis",459,0,459,51,9
2016,34,"LV","Pipiens",32,214,246,8,4
2016,34,"LV","Tarsalis",153,0,153,8,19.12
2016,34,"NE","Pipiens",68,96,164,10,6.8
2016,34,"NE","Tarsalis",27,0,27,10,2.7
2016,34,"NW","Pipiens",60,262,322,9,6.67
2016,34,"NW","Tarsalis",87,0,87,9,9.67
2016,34,"SE","Pipiens",49,170,219,15,3.27
2016,34,"SE","Tarsalis",124,0,124,15,8.27
2016,34,"SW","Pipiens",9,62,71,9,1
2016,34,"SW","Tarsalis",68,0,68,9,7.56
2016,35,"FC","Pipiens",319,153,472,49,6.51
2016,35,"FC","Tarsalis",229,0,229,49,4.67
2016,35,"LV","Pipiens",8,0,8,6,1.33
2016,35,"LV","Tarsalis",53,0,53,6,8.83
2016,35,"NE","Pipiens",128,53,181,10,12.8
2016,35,"NE","Tarsalis",28,0,28,10,2.8
2016,35,"NW","Pipiens",111,25,136,9,12.33
2016,35,"NW","Tarsalis",25,0,25,9,2.78
2016,35,"SE","Pipiens",64,70,134,15,4.27
2016,35,"SE","Tarsalis",108,0,108,15,7.2
2016,35,"SW","Pipiens",8,5,13,9,0.89
2016,35,"SW","Tarsalis",15,0,15,9,1.67
2016,36,"FC","Pipiens",387,93,480,43,9
2016,36,"FC","Tarsalis",159,0,159,43,3.7
2016,36,"NE","Pipiens",218,50,268,10,21.8
2016,36,"NE","Tarsalis",38,0,38,10,3.8
2016,36,"NW","Pipiens",124,14,138,9,13.78
2016,36,"NW","Tarsalis",57,0,57,9,6.33
2016,36,"SE","Pipiens",33,15,48,15,2.2
2016,36,"SE","Tarsalis",35,0,35,15,2.33
2016,36,"SW","Pipiens",12,14,26,9,1.33
2016,36,"SW","Tarsalis",29,0,29,9,3.22
2016,37,"FC","Pipiens",277,46,323,43,6.44
2016,37,"FC","Tarsalis",66,0,66,43,1.53
2016,37,"NE","Pipiens",79,20,99,10,7.9
2016,37,"NE","Tarsalis",25,0,25,10,2.5
2016,37,"NW","Pipiens",179,17,196,9,19.89
2016,37,"NW","Tarsalis",18,0,18,9,2
2016,37,"SE","Pipiens",15,9,24,15,1
2016,37,"SE","Tarsalis",17,0,17,15,1.13
2016,37,"SW","Pipiens",4,0,4,9,0.44
2016,37,"SW","Tarsalis",6,0,6,9,0.67
2017,24,"BE","Pipiens",0,0,0,4,0
2017,24,"BE","Tarsalis",33,0,33,4,8.25
2017,24,"FC","Pipiens",15,27,42,53,0.28
2017,24,"FC","Tarsalis",200,0,200,53,3.77
2017,24,"LV","Pipiens",1,0,1,6,0.17
2017,24,"LV","Tarsalis",50,0,50,6,8.33
2017,24,"NE","Pipiens",4,8,12,10,0.4
2017,24,"NE","Tarsalis",28,0,28,10,2.8
2017,24,"NW","Pipiens",4,0,4,9,0.44
2017,24,"NW","Tarsalis",19,0,19,9,2.11
2017,24,"SE","Pipiens",4,19,23,15,0.27
2017,24,"SE","Tarsalis",65,0,65,15,4.33
2017,24,"SW","Pipiens",2,0,2,9,0.22
2017,24,"SW","Tarsalis",5,0,5,9,0.56
2017,25,"BE","Pipiens",2,0,2,4,0.5
2017,25,"BE","Tarsalis",314,0,314,4,78.5
2017,25,"FC","Pipiens",21,134,155,53,0.4
2017,25,"FC","Tarsalis",743,0,743,53,14.02
2017,25,"LV","Pipiens",1,0,1,6,0.17
2017,25,"LV","Tarsalis",165,0,165,6,27.5
2017,25,"NE","Pipiens",2,17,19,10,0.2
2017,25,"NE","Tarsalis",38,0,38,10,3.8
2017,25,"NW","Pipiens",3,40,43,9,0.33
2017,25,"NW","Tarsalis",10,0,10,9,1.11
2017,25,"SE","Pipiens",7,57,64,15,0.47
2017,25,"SE","Tarsalis",198,0,198,15,13.2
2017,25,"SW","Pipiens",6,20,26,9,0.67
2017,25,"SW","Tarsalis",18,0,18,9,2
2017,26,"BE","Pipiens",0,0,0,4,0
2017,26,"BE","Tarsalis",116,0,116,4,29
2017,26,"FC","Pipiens",75,201,276,53,1.42
2017,26,"FC","Tarsalis",1189,2,1191,53,22.43
2017,26,"LV","Pipiens",5,0,5,6,0.83
2017,26,"LV","Tarsalis",234,0,234,6,39
2017,26,"NE","Pipiens",20,23,43,10,2
2017,26,"NE","Tarsalis",79,1,80,10,7.9
2017,26,"NW","Pipiens",25,55,80,9,2.78
2017,26,"NW","Tarsalis",76,0,76,9,8.44
2017,26,"SE","Pipiens",21,92,113,15,1.4
2017,26,"SE","Tarsalis",638,1,639,15,42.53
2017,26,"SW","Pipiens",4,31,35,9,0.44
2017,26,"SW","Tarsalis",46,0,46,9,5.11
2017,27,"BE","Pipiens",4,0,4,4,1
2017,27,"BE","Tarsalis",234,0,234,4,58.5
2017,27,"FC","Pipiens",55,408,463,53,1.04
2017,27,"FC","Tarsalis",1389,2,1391,53,26.21
2017,27,"LV","Pipiens",4,0,4,6,0.67
2017,27,"LV","Tarsalis",280,0,280,6,46.67
2017,27,"NE","Pipiens",20,59,79,10,2
2017,27,"NE","Tarsalis",309,2,311,10,30.9
2017,27,"NW","Pipiens",12,159,171,9,1.33
2017,27,"NW","Tarsalis",89,0,89,9,9.89
2017,27,"SE","Pipiens",12,168,180,15,0.8
2017,27,"SE","Tarsalis",462,0,462,15,30.8
2017,27,"SW","Pipiens",3,22,25,9,0.33
2017,27,"SW","Tarsalis",15,0,15,9,1.67
2017,28,"BE","Pipiens",2,0,2,4,0.5
2017,28,"BE","Tarsalis",469,0,469,4,117.25
2017,28,"FC","Pipiens",163,612,775,53,3.08
2017,28,"FC","Tarsalis",4806,6,4812,53,90.68
2017,28,"LV","Pipiens",10,0,10,6,1.67
2017,28,"LV","Tarsalis",350,0,350,6,58.33
2017,28,"NE","Pipiens",13,293,306,10,1.3
2017,28,"NE","Tarsalis",330,6,336,10,33
2017,28,"NW","Pipiens",18,64,82,9,2
2017,28,"NW","Tarsalis",111,0,111,9,12.33
2017,28,"SE","Pipiens",110,242,352,15,7.33
2017,28,"SE","Tarsalis",3503,0,3503,15,233.53
2017,28,"SW","Pipiens",10,13,23,9,1.11
2017,28,"SW","Tarsalis",43,0,43,9,4.78
2017,29,"BE","Pipiens",19,0,19,4,4.75
2017,29,"BE","Tarsalis",388,0,388,4,97
2017,29,"FC","Pipiens",120,761,881,53,2.26
2017,29,"FC","Tarsalis",3838,11,3849,53,72.42
2017,29,"LV","Pipiens",13,0,13,6,2.17
2017,29,"LV","Tarsalis",593,0,593,6,98.83
2017,29,"NE","Pipiens",38,274,312,10,3.8
2017,29,"NE","Tarsalis",932,1,933,10,93.2
2017,29,"NW","Pipiens",10,97,107,9,1.11
2017,29,"NW","Tarsalis",216,1,217,9,24
2017,29,"SE","Pipiens",36,286,322,15,2.4
2017,29,"SE","Tarsalis",1600,9,1609,15,106.67
2017,29,"SW","Pipiens",4,104,108,9,0.44
2017,29,"SW","Tarsalis",109,0,109,9,12.11
2017,30,"BE","Pipiens",2,0,2,4,0.5
2017,30,"BE","Tarsalis",25,0,25,4,6.25
2017,30,"FC","Pipiens",189,959,1148,53,3.57
2017,30,"FC","Tarsalis",3202,0,3202,53,60.42
2017,30,"LV","Pipiens",11,0,11,6,1.83
2017,30,"LV","Tarsalis",1077,0,1077,6,179.5
2017,30,"NE","Pipiens",97,604,701,10,9.7
2017,30,"NE","Tarsalis",599,0,599,10,59.9
2017,30,"NW","Pipiens",40,135,175,9,4.44
2017,30,"NW","Tarsalis",290,0,290,9,32.22
2017,30,"SE","Pipiens",20,152,172,15,1.33
2017,30,"SE","Tarsalis",1118,0,1118,15,74.53
2017,30,"SW","Pipiens",19,68,87,9,2.11
2017,30,"SW","Tarsalis",93,0,93,9,10.33
2017,31,"BE","Pipiens",11,0,11,4,2.75
2017,31,"BE","Tarsalis",154,0,154,4,38.5
2017,31,"FC","Pipiens",199,900,1099,53,3.75
2017,31,"FC","Tarsalis",2068,2,2070,53,39.02
2017,31,"LV","Pipiens",11,0,11,6,1.83
2017,31,"LV","Tarsalis",505,0,505,6,84.17
2017,31,"NE","Pipiens",45,166,211,10,4.5
2017,31,"NE","Tarsalis",237,1,238,10,23.7
2017,31,"NW","Pipiens",46,175,221,9,5.11
2017,31,"NW","Tarsalis",158,1,159,9,17.56
2017,31,"SE","Pipiens",71,496,567,15,4.73
2017,31,"SE","Tarsalis",865,0,865,15,57.67
2017,31,"SW","Pipiens",15,63,78,9,1.67
2017,31,"SW","Tarsalis",149,0,149,9,16.56
2017,32,"BE","Pipiens",4,0,4,4,1
2017,32,"BE","Tarsalis",105,0,105,4,26.25
2017,32,"FC","Pipiens",300,169,469,53,5.66
2017,32,"FC","Tarsalis",794,0,794,53,14.98
2017,32,"LV","Pipiens",4,0,4,6,0.67
2017,32,"LV","Tarsalis",130,0,130,6,21.67
2017,32,"NE","Pipiens",127,33,160,10,12.7
2017,32,"NE","Tarsalis",122,0,122,10,12.2
2017,32,"NW","Pipiens",95,33,128,9,10.56
2017,32,"NW","Tarsalis",73,0,73,9,8.11
2017,32,"SE","Pipiens",61,82,143,15,4.07
2017,32,"SE","Tarsalis",336,0,336,15,22.4
2017,32,"SW","Pipiens",9,21,30,9,1
2017,32,"SW","Tarsalis",28,0,28,9,3.11
2017,33,"BE","Pipiens",15,0,15,4,3.75
2017,33,"BE","Tarsalis",56,0,56,4,14
2017,33,"FC","Pipiens",280,161,441,53,5.28
2017,33,"FC","Tarsalis",571,3,574,53,10.77
2017,33,"LV","Pipiens",14,0,14,6,2.33
2017,33,"LV","Tarsalis",129,0,129,6,21.5
2017,33,"NE","Pipiens",104,36,140,10,10.4
2017,33,"NE","Tarsalis",114,3,117,10,11.4
2017,33,"NW","Pipiens",79,7,86,9,8.78
2017,33,"NW","Tarsalis",78,0,78,9,8.67
2017,33,"SE","Pipiens",53,82,135,15,3.53
2017,33,"SE","Tarsalis",145,0,145,15,9.67
2017,33,"SW","Pipiens",15,36,51,9,1.67
2017,33,"SW","Tarsalis",49,0,49,9,5.44
2017,34,"BE","Pipiens",28,0,28,4,7
2017,34,"BE","Tarsalis",95,0,95,4,23.75
2017,34,"FC","Pipiens",271,287,558,53,5.11
2017,34,"FC","Tarsalis",698,0,698,53,13.17
2017,34,"LV","Pipiens",14,0,14,6,2.33
2017,34,"LV","Tarsalis",185,0,185,6,30.83
2017,34,"NE","Pipiens",66,59,125,10,6.6
2017,34,"NE","Tarsalis",77,0,77,10,7.7
2017,34,"NW","Pipiens",66,29,95,9,7.33
2017,34,"NW","Tarsalis",67,0,67,9,7.44
2017,34,"SE","Pipiens",90,183,273,15,6
2017,34,"SE","Tarsalis",218,0,218,15,14.53
2017,34,"SW","Pipiens",7,16,23,9,0.78
2017,34,"SW","Tarsalis",56,0,56,9,6.22
2017,35,"BE","Pipiens",0,0,0,4,0
2017,35,"BE","Tarsalis",6,0,6,4,1.5
2017,35,"FC","Pipiens",197,227,424,53,3.72
2017,35,"FC","Tarsalis",320,3,323,53,6.04
2017,35,"LV","Pipiens",6,0,6,6,1
2017,35,"LV","Tarsalis",55,0,55,6,9.17
2017,35,"NE","Pipiens",116,93,209,10,11.6
2017,35,"NE","Tarsalis",98,3,101,10,9.8
2017,35,"NW","Pipiens",24,42,66,9,2.67
2017,35,"NW","Tarsalis",60,0,60,9,6.67
2017,35,"SE","Pipiens",48,82,130,15,3.2
2017,35,"SE","Tarsalis",85,0,85,15,5.67
2017,35,"SW","Pipiens",3,10,13,9,0.33
2017,35,"SW","Tarsalis",16,0,16,9,1.78
2017,36,"FC","Pipiens",128,96,224,49,2.61
2017,36,"FC","Tarsalis",105,0,105,49,2.14
2017,36,"LV","Pipiens",12,0,12,6,2
2017,36,"LV","Tarsalis",38,0,38,6,6.33
2017,36,"NE","Pipiens",47,70,117,10,4.7
2017,36,"NE","Tarsalis",14,0,14,10,1.4
2017,36,"NW","Pipiens",16,14,30,9,1.78
2017,36,"NW","Tarsalis",24,0,24,9,2.67
2017,36,"SE","Pipiens",49,12,61,15,3.27
2017,36,"SE","Tarsalis",13,0,13,15,0.87
2017,36,"SW","Pipiens",4,0,4,9,0.44
2017,36,"SW","Tarsalis",16,0,16,9,1.78
2018,24,"BE","Pipiens",0,0,0,4,0
2018,24,"BE","Tarsalis",93,0,93,4,23.25
2018,24,"FC","Pipiens",33,100,133,53,0.62
2018,24,"FC","Tarsalis",602,0,602,53,11.36
2018,24,"LV","Pipiens",0,0,0,6,0
2018,24,"LV","Tarsalis",121,0,121,6,20.17
2018,24,"NE","Pipiens",0,6,6,10,0
2018,24,"NE","Tarsalis",65,0,65,10,6.5
2018,24,"NW","Pipiens",18,4,22,9,2
2018,24,"NW","Tarsalis",76,0,76,9,8.44
2018,24,"SE","Pipiens",13,88,101,15,0.87
2018,24,"SE","Tarsalis",216,0,216,15,14.4
2018,24,"SW","Pipiens",2,2,4,9,0.22
2018,24,"SW","Tarsalis",31,0,31,9,3.44
2018,25,"BE","Pipiens",3,0,3,4,0.75
2018,25,"BE","Tarsalis",22,0,22,4,5.5
2018,25,"FC","Pipiens",51,114,165,53,0.96
2018,25,"FC","Tarsalis",462,0,462,53,8.72
2018,25,"LV","Pipiens",3,0,3,6,0.5
2018,25,"LV","Tarsalis",110,0,110,6,18.33
2018,25,"NE","Pipiens",9,25,34,10,0.9
2018,25,"NE","Tarsalis",22,0,22,10,2.2
2018,25,"NW","Pipiens",4,12,16,9,0.44
2018,25,"NW","Tarsalis",23,0,23,9,2.56
2018,25,"SE","Pipiens",28,77,105,15,1.87
2018,25,"SE","Tarsalis",260,0,260,15,17.33
2018,25,"SW","Pipiens",4,0,4,9,0.44
2018,25,"SW","Tarsalis",25,0,25,9,2.78
2018,26,"BE","Pipiens",5,0,5,4,1.25
2018,26,"BE","Tarsalis",191,0,191,4,47.75
2018,26,"FC","Pipiens",109,150,259,53,2.06
2018,26,"FC","Tarsalis",1451,1,1452,53,27.38
2018,26,"LV","Pipiens",2,0,2,6,0.33
2018,26,"LV","Tarsalis",158,0,158,6,26.33
2018,26,"NE","Pipiens",25,18,43,10,2.5
2018,26,"NE","Tarsalis",152,0,152,10,15.2
2018,26,"NW","Pipiens",30,36,66,9,3.33
2018,26,"NW","Tarsalis",171,0,171,9,19
2018,26,"SE","Pipiens",35,82,117,15,2.33
2018,26,"SE","Tarsalis",540,1,541,15,36
2018,26,"SW","Pipiens",12,14,26,9,1.33
2018,26,"SW","Tarsalis",239,0,239,9,26.56
2018,27,"BE","Pipiens",10,0,10,4,2.5
2018,27,"BE","Tarsalis",355,0,355,4,88.75
2018,27,"FC","Pipiens",184,536,720,53,3.47
2018,27,"FC","Tarsalis",2810,0,2810,53,53.02
2018,27,"LV","Pipiens",0,0,0,6,0
2018,27,"LV","Tarsalis",320,0,320,6,53.33
2018,27,"NE","Pipiens",21,121,142,10,2.1
2018,27,"NE","Tarsalis",729,0,729,10,72.9
2018,27,"NW","Pipiens",99,78,177,9,11
2018,27,"NW","Tarsalis",267,0,267,9,29.67
2018,27,"SE","Pipiens",54,266,320,15,3.6
2018,27,"SE","Tarsalis",912,0,912,15,60.8
2018,27,"SW","Pipiens",0,71,71,9,0
2018,27,"SW","Tarsalis",227,0,227,9,25.22
2018,28,"BE","Pipiens",10,0,10,4,2.5
2018,28,"BE","Tarsalis",997,0,997,4,249.25
2018,28,"FC","Pipiens",170,750,920,53,3.21
2018,28,"FC","Tarsalis",4382,0,4382,53,82.68
2018,28,"LV","Pipiens",8,0,8,6,1.33
2018,28,"LV","Tarsalis",746,0,746,6,124.33
2018,28,"NE","Pipiens",48,114,162,10,4.8
2018,28,"NE","Tarsalis",857,0,857,10,85.7
2018,28,"NW","Pipiens",34,211,245,9,3.78
2018,28,"NW","Tarsalis",411,0,411,9,45.67
2018,28,"SE","Pipiens",63,369,432,15,4.2
2018,28,"SE","Tarsalis",1144,0,1144,15,76.27
2018,28,"SW","Pipiens",7,56,63,9,0.78
2018,28,"SW","Tarsalis",227,0,227,9,25.22
2018,29,"BE","Pipiens",18,0,18,4,4.5
2018,29,"BE","Tarsalis",186,0,186,4,46.5
2018,29,"FC","Pipiens",138,829,967,53,2.6
2018,29,"FC","Tarsalis",1744,0,1744,53,32.91
2018,29,"LV","Pipiens",6,0,6,6,1
2018,29,"LV","Tarsalis",228,0,228,6,38
2018,29,"NE","Pipiens",55,84,139,10,5.5
2018,29,"NE","Tarsalis",139,0,139,10,13.9
2018,29,"NW","Pipiens",40,35,75,9,4.44
2018,29,"NW","Tarsalis",316,0,316,9,35.11
2018,29,"SE","Pipiens",12,692,704,15,0.8
2018,29,"SE","Tarsalis",659,0,659,15,43.93
2018,29,"SW","Pipiens",7,18,25,9,0.78
2018,29,"SW","Tarsalis",216,0,216,9,24
2018,30,"BE","Pipiens",21,0,21,4,5.25
2018,30,"BE","Tarsalis",312,0,312,4,78
2018,30,"FC","Pipiens",306,883,1189,53,5.77
2018,30,"FC","Tarsalis",1854,0,1854,53,34.98
2018,30,"LV","Pipiens",0,0,0,6,0
2018,30,"LV","Tarsalis",205,0,205,6,34.17
2018,30,"NE","Pipiens",186,52,238,10,18.6
2018,30,"NE","Tarsalis",590,0,590,10,59
2018,30,"NW","Pipiens",70,523,593,9,7.78
2018,30,"NW","Tarsalis",341,0,341,9,37.89
2018,30,"SE","Pipiens",29,241,270,15,1.93
2018,30,"SE","Tarsalis",302,0,302,15,20.13
2018,30,"SW","Pipiens",0,67,67,9,0
2018,30,"SW","Tarsalis",104,0,104,9,11.56
2018,31,"BE","Pipiens",22,0,22,4,5.5
2018,31,"BE","Tarsalis",313,0,313,4,78.25
2018,31,"FC","Pipiens",817,1276,2093,53,15.42
2018,31,"FC","Tarsalis",1749,0,1749,53,33
2018,31,"LV","Pipiens",28,0,28,6,4.67
2018,31,"LV","Tarsalis",126,0,126,6,21
2018,31,"NE","Pipiens",392,115,507,10,39.2
2018,31,"NE","Tarsalis",275,0,275,10,27.5
2018,31,"NW","Pipiens",91,311,402,9,10.11
2018,31,"NW","Tarsalis",258,0,258,9,28.67
2018,31,"SE","Pipiens",245,536,781,15,16.33
2018,31,"SE","Tarsalis",545,0,545,15,36.33
2018,31,"SW","Pipiens",39,314,353,9,4.33
2018,31,"SW","Tarsalis",232,0,232,9,25.78
2018,32,"BE","Pipiens",28,0,28,4,7
2018,32,"BE","Tarsalis",130,0,130,4,32.5
2018,32,"FC","Pipiens",1024,879,1903,53,19.32
2018,32,"FC","Tarsalis",1261,0,1261,53,23.79
2018,32,"LV","Pipiens",17,0,17,6,2.83
2018,32,"LV","Tarsalis",114,0,114,6,19
2018,32,"NE","Pipiens",394,286,680,10,39.4
2018,32,"NE","Tarsalis",248,0,248,10,24.8
2018,32,"NW","Pipiens",286,107,393,9,31.78
2018,32,"NW","Tarsalis",279,0,279,9,31
2018,32,"SE","Pipiens",244,409,653,15,16.27
2018,32,"SE","Tarsalis",375,0,375,15,25
2018,32,"SW","Pipiens",55,77,132,9,6.11
2018,32,"SW","Tarsalis",115,0,115,9,12.78
2018,33,"BE","Pipiens",7,0,7,4,1.75
2018,33,"BE","Tarsalis",86,0,86,4,21.5
2018,33,"FC","Pipiens",1084,638,1722,53,20.45
2018,33,"FC","Tarsalis",1761,0,1761,53,33.23
2018,33,"LV","Pipiens",21,0,21,6,3.5
2018,33,"LV","Tarsalis",200,0,200,6,33.33
2018,33,"NE","Pipiens",742,144,886,10,74.2
2018,33,"NE","Tarsalis",694,0,694,10,69.4
2018,33,"NW","Pipiens",121,37,158,9,13.44
2018,33,"NW","Tarsalis",193,0,193,9,21.44
2018,33,"SE","Pipiens",143,444,587,15,9.53
2018,33,"SE","Tarsalis",429,0,429,15,28.6
2018,33,"SW","Pipiens",50,13,63,9,5.56
2018,33,"SW","Tarsalis",159,0,159,9,17.67
2018,34,"BE","Pipiens",1,0,1,4,0.25
2018,34,"BE","Tarsalis",40,0,40,4,10
2018,34,"FC","Pipiens",572,402,974,53,10.79
2018,34,"FC","Tarsalis",531,0,531,53,10.02
2018,34,"LV","Pipiens",45,0,45,6,7.5
2018,34,"LV","Tarsalis",43,0,43,6,7.17
2018,34,"NE","Pipiens",240,61,301,10,24
2018,34,"NE","Tarsalis",133,0,133,10,13.3
2018,34,"NW","Pipiens",90,116,206,9,10
2018,34,"NW","Tarsalis",99,0,99,9,11
2018,34,"SE","Pipiens",178,175,353,15,11.87
2018,34,"SE","Tarsalis",167,0,167,15,11.13
2018,34,"SW","Pipiens",18,50,68,9,2
2018,34,"SW","Tarsalis",49,0,49,9,5.44
2018,35,"BE","Pipiens",15,0,15,4,3.75
2018,35,"BE","Tarsalis",19,0,19,4,4.75
2018,35,"FC","Pipiens",547,271,818,53,10.32
2018,35,"FC","Tarsalis",462,0,462,53,8.72
2018,35,"LV","Pipiens",23,0,23,6,3.83
2018,35,"LV","Tarsalis",86,0,86,6,14.33
2018,35,"NE","Pipiens",352,101,453,10,35.2
2018,35,"NE","Tarsalis",142,0,142,10,14.2
2018,35,"NW","Pipiens",69,41,110,9,7.67
2018,35,"NW","Tarsalis",46,0,46,9,5.11
2018,35,"SE","Pipiens",79,117,196,15,5.27
2018,35,"SE","Tarsalis",150,0,150,15,10
2018,35,"SW","Pipiens",9,12,21,9,1
2018,35,"SW","Tarsalis",19,0,19,9,2.11
2018,36,"FC","Pipiens",590,209,799,43,13.72
2018,36,"FC","Tarsalis",196,2,198,43,4.56
2018,36,"NE","Pipiens",438,89,527,10,43.8
2018,36,"NE","Tarsalis",98,2,100,10,9.8
2018,36,"NW","Pipiens",88,87,175,9,9.78
2018,36,"NW","Tarsalis",38,0,38,9,4.22
2018,36,"SE","Pipiens",51,26,77,15,3.4
2018,36,"SE","Tarsalis",50,0,50,15,3.33
2018,36,"SW","Pipiens",13,7,20,9,1.44
2018,36,"SW","Tarsalis",10,0,10,9,1.11
2018,37,"FC","Pipiens",235,449,684,43,5.47
2018,37,"FC","Tarsalis",47,0,47,43,1.09
2018,37,"NE","Pipiens",181,96,277,10,18.1
2018,37,"NE","Tarsalis",21,0,21,10,2.1
2018,37,"NW","Pipiens",33,126,159,9,3.67
2018,37,"NW","Tarsalis",21,0,21,9,2.33
2018,37,"SE","Pipiens",21,217,238,15,1.4
2018,37,"SE","Tarsalis",0,0,0,15,0
2018,37,"SW","Pipiens",0,10,10,9,0
2018,37,"SW","Tarsalis",5,0,5,9,0.56
2019,24,"BE","Pipiens",0,0,0,4,0
2019,24,"BE","Tarsalis",5,0,5,4,1.25
2019,24,"FC","Pipiens",5,0,5,44,0.11
2019,24,"FC","Tarsalis",71,0,71,44,1.61
2019,24,"LV","Pipiens",0,0,0,6,0
2019,24,"LV","Tarsalis",27,0,27,6,4.5
2019,24,"NE","Pipiens",0,0,0,10,0
2019,24,"NE","Tarsalis",16,0,16,10,1.6
2019,24,"SE","Pipiens",0,0,0,15,0
2019,24,"SE","Tarsalis",23,0,23,15,1.53
2019,24,"SW","Pipiens",5,0,5,9,0.56
2019,24,"SW","Tarsalis",0,0,0,9,0
2019,25,"BE","Pipiens",0,0,0,4,0
2019,25,"BE","Tarsalis",4,0,4,4,1
2019,25,"FC","Pipiens",1,22,23,53,0.02
2019,25,"FC","Tarsalis",40,0,40,53,0.75
2019,25,"LV","Pipiens",0,0,0,6,0
2019,25,"LV","Tarsalis",12,0,12,6,2
2019,25,"NE","Pipiens",0,3,3,10,0
2019,25,"NE","Tarsalis",6,0,6,10,0.6
2019,25,"NW","Pipiens",1,0,1,9,0.11
2019,25,"NW","Tarsalis",2,0,2,9,0.22
2019,25,"SE","Pipiens",0,13,13,15,0
2019,25,"SE","Tarsalis",10,0,10,15,0.67
2019,25,"SW","Pipiens",0,6,6,9,0
2019,25,"SW","Tarsalis",6,0,6,9,0.67
2019,26,"BE","Pipiens",1,0,1,4,0.25
2019,26,"BE","Tarsalis",13,0,13,4,3.25
2019,26,"FC","Pipiens",8,11,19,53,0.15
2019,26,"FC","Tarsalis",217,0,217,53,4.09
2019,26,"LV","Pipiens",0,0,0,6,0
2019,26,"LV","Tarsalis",15,0,15,6,2.5
2019,26,"NE","Pipiens",0,3,3,10,0
2019,26,"NE","Tarsalis",9,0,9,10,0.9
2019,26,"NW","Pipiens",2,4,6,9,0.22
2019,26,"NW","Tarsalis",9,0,9,9,1
2019,26,"SE","Pipiens",5,4,9,15,0.33
2019,26,"SE","Tarsalis",161,0,161,15,10.73
2019,26,"SW","Pipiens",0,0,0,9,0
2019,26,"SW","Tarsalis",10,0,10,9,1.11
2019,27,"BE","Pipiens",0,0,0,4,0
2019,27,"BE","Tarsalis",168,0,168,4,42
2019,27,"FC","Pipiens",7,58,65,53,0.13
2019,27,"FC","Tarsalis",1130,0,1130,53,21.32
2019,27,"LV","Pipiens",0,0,0,6,0
2019,27,"LV","Tarsalis",277,0,277,6,46.17
2019,27,"NE","Pipiens",4,10,14,10,0.4
2019,27,"NE","Tarsalis",272,0,272,10,27.2
2019,27,"NW","Pipiens",0,5,5,9,0
2019,27,"NW","Tarsalis",34,0,34,9,3.78
2019,27,"SE","Pipiens",2,43,45,15,0.13
2019,27,"SE","Tarsalis",349,0,349,15,23.27
2019,27,"SW","Pipiens",1,0,1,9,0.11
2019,27,"SW","Tarsalis",30,0,30,9,3.33
2019,28,"BE","Pipiens",0,0,0,5,0
2019,28,"BE","Tarsalis",364,0,364,5,72.8
2019,28,"FC","Pipiens",53,46,99,54,0.98
2019,28,"FC","Tarsalis",2623,0,2623,54,48.57
2019,28,"LV","Pipiens",5,0,5,6,0.83
2019,28,"LV","Tarsalis",426,0,426,6,71
2019,28,"NE","Pipiens",16,4,20,10,1.6
2019,28,"NE","Tarsalis",396,0,396,10,39.6
2019,28,"NW","Pipiens",0,12,12,9,0
2019,28,"NW","Tarsalis",99,0,99,9,11
2019,28,"SE","Pipiens",26,27,53,15,1.73
2019,28,"SE","Tarsalis",1200,0,1200,15,80
2019,28,"SW","Pipiens",6,3,9,9,0.67
2019,28,"SW","Tarsalis",138,0,138,9,15.33
2019,29,"BE","Pipiens",7,0,7,5,1.4
2019,29,"BE","Tarsalis",302,0,302,5,60.4
2019,29,"FC","Pipiens",101,126,227,54,1.87
2019,29,"FC","Tarsalis",2399,4,2403,54,44.43
2019,29,"LV","Pipiens",3,0,3,6,0.5
2019,29,"LV","Tarsalis",316,0,316,6,52.67
2019,29,"NE","Pipiens",44,6,50,10,4.4
2019,29,"NE","Tarsalis",665,0,665,10,66.5
2019,29,"NW","Pipiens",18,11,29,9,2
2019,29,"NW","Tarsalis",98,0,98,9,10.89
2019,29,"SE","Pipiens",29,103,132,15,1.93
2019,29,"SE","Tarsalis",902,4,906,15,60.13
2019,29,"SW","Pipiens",0,6,6,9,0
2019,29,"SW","Tarsalis",116,0,116,9,12.89
2019,30,"BE","Pipiens",33,0,33,5,6.6
2019,30,"BE","Tarsalis",321,0,321,5,64.2
2019,30,"FC","Pipiens",182,100,282,54,3.37
2019,30,"FC","Tarsalis",2421,0,2421,54,44.83
2019,30,"LV","Pipiens",5,0,5,6,0.83
2019,30,"LV","Tarsalis",519,0,519,6,86.5
2019,30,"NE","Pipiens",24,9,33,10,2.4
2019,30,"NE","Tarsalis",356,0,356,10,35.6
2019,30,"NW","Pipiens",40,34,74,9,4.44
2019,30,"NW","Tarsalis",165,0,165,9,18.33
2019,30,"SE","Pipiens",48,33,81,15,3.2
2019,30,"SE","Tarsalis",883,0,883,15,58.87
2019,30,"SW","Pipiens",32,24,56,9,3.56
2019,30,"SW","Tarsalis",177,0,177,9,19.67
2019,31,"BE","Pipiens",38,0,38,5,7.6
2019,31,"BE","Tarsalis",414,0,414,5,82.8
2019,31,"FC","Pipiens",391,239,630,54,7.24
2019,31,"FC","Tarsalis",4723,4,4727,54,87.46
2019,31,"LV","Pipiens",8,0,8,6,1.33
2019,31,"LV","Tarsalis",743,0,743,6,123.83
2019,31,"NE","Pipiens",125,57,182,10,12.5
2019,31,"NE","Tarsalis",1304,4,1308,10,130.4
2019,31,"NW","Pipiens",85,24,109,9,9.44
2019,31,"NW","Tarsalis",539,0,539,9,59.89
2019,31,"SE","Pipiens",119,124,243,15,7.93
2019,31,"SE","Tarsalis",1506,0,1506,15,100.4
2019,31,"SW","Pipiens",16,34,50,9,1.78
2019,31,"SW","Tarsalis",217,0,217,9,24.11
2019,32,"BE","Pipiens",24,0,24,5,4.8
2019,32,"BE","Tarsalis",403,0,403,5,80.6
2019,32,"FC","Pipiens",313,587,900,56,5.59
2019,32,"FC","Tarsalis",3629,0,3629,56,64.8
2019,32,"LV","Pipiens",7,0,7,8,0.88
2019,32,"LV","Tarsalis",552,0,552,8,69
2019,32,"NE","Pipiens",61,80,141,10,6.1
2019,32,"NE","Tarsalis",992,0,992,10,99.2
2019,32,"NW","Pipiens",52,134,186,9,5.78
2019,32,"NW","Tarsalis",331,0,331,9,36.78
2019,32,"SE","Pipiens",134,327,461,15,8.93
2019,32,"SE","Tarsalis",1101,0,1101,15,73.4
2019,32,"SW","Pipiens",35,46,81,9,3.89
2019,32,"SW","Tarsalis",250,0,250,9,27.78
2019,33,"BE","Pipiens",25,0,25,5,5
2019,33,"BE","Tarsalis",252,0,252,5,50.4
2019,33,"FC","Pipiens",353,311,664,55,6.42
2019,33,"FC","Tarsalis",3344,3,3347,55,60.8
2019,33,"LV","Pipiens",12,0,12,7,1.71
2019,33,"LV","Tarsalis",256,0,256,7,36.57
2019,33,"NE","Pipiens",110,85,195,10,11
2019,33,"NE","Tarsalis",624,3,627,10,62.4
2019,33,"NW","Pipiens",38,59,97,9,4.22
2019,33,"NW","Tarsalis",354,0,354,9,39.33
2019,33,"SE","Pipiens",145,140,285,15,9.67
2019,33,"SE","Tarsalis",1546,0,1546,15,103.07
2019,33,"SW","Pipiens",23,27,50,9,2.56
2019,33,"SW","Tarsalis",312,0,312,9,34.67
2019,34,"BE","Pipiens",12,0,12,5,2.4
2019,34,"BE","Tarsalis",77,0,77,5,15.4
2019,34,"FC","Pipiens",364,645,1009,54,6.74
2019,34,"FC","Tarsalis",1456,0,1456,54,26.96
2019,34,"LV","Pipiens",45,0,45,6,7.5
2019,34,"LV","Tarsalis",249,0,249,6,41.5
2019,34,"NE","Pipiens",132,102,234,10,13.2
2019,34,"NE","Tarsalis",361,0,361,10,36.1
2019,34,"NW","Pipiens",53,129,182,9,5.89
2019,34,"NW","Tarsalis",210,0,210,9,23.33
2019,34,"SE","Pipiens",111,357,468,15,7.4
2019,34,"SE","Tarsalis",426,0,426,15,28.4
2019,34,"SW","Pipiens",11,57,68,9,1.22
2019,34,"SW","Tarsalis",133,0,133,9,14.78
2019,35,"BE","Pipiens",13,0,13,5,2.6
2019,35,"BE","Tarsalis",77,0,77,5,15.4
2019,35,"FC","Pipiens",377,284,661,54,6.98
2019,35,"FC","Tarsalis",1396,0,1396,54,25.85
2019,35,"LV","Pipiens",16,0,16,6,2.67
2019,35,"LV","Tarsalis",94,0,94,6,15.67
2019,35,"NE","Pipiens",129,84,213,10,12.9
2019,35,"NE","Tarsalis",502,0,502,10,50.2
2019,35,"NW","Pipiens",39,35,74,9,4.33
2019,35,"NW","Tarsalis",136,0,136,9,15.11
2019,35,"SE","Pipiens",158,111,269,15,10.53
2019,35,"SE","Tarsalis",361,0,361,15,24.07
2019,35,"SW","Pipiens",22,54,76,9,2.44
2019,35,"SW","Tarsalis",226,0,226,9,25.11
2019,36,"FC","Pipiens",350,557,907,43,8.14
2019,36,"FC","Tarsalis",1038,0,1038,43,24.14
2019,36,"NE","Pipiens",187,194,381,10,18.7
2019,36,"NE","Tarsalis",309,0,309,10,30.9
2019,36,"NW","Pipiens",55,151,206,9,6.11
2019,36,"NW","Tarsalis",225,0,225,9,25
2019,36,"SE","Pipiens",85,181,266,15,5.67
2019,36,"SE","Tarsalis",375,0,375,15,25
2019,36,"SW","Pipiens",23,31,54,9,2.56
2019,36,"SW","Tarsalis",129,0,129,9,14.33
2019,37,"FC","Pipiens",247,152,399,43,5.74
2019,37,"FC","Tarsalis",154,0,154,43,3.58
2019,37,"NE","Pipiens",74,12,86,10,7.4
2019,37,"NE","Tarsalis",13,0,13,10,1.3
2019,37,"NW","Pipiens",32,49,81,9,3.56
2019,37,"NW","Tarsalis",24,0,24,9,2.67
2019,37,"SE","Pipiens",128,80,208,15,8.53
2019,37,"SE","Tarsalis",104,0,104,15,6.93
2019,37,"SW","Pipiens",13,11,24,9,1.44
2019,37,"SW","Tarsalis",13,0,13,9,1.44
2020,24,"BE","Pipiens",1,0,1,5,0.2
2020,24,"BE","Tarsalis",2,0,2,5,0.4
2020,24,"FC","Pipiens",13,58,71,54,0.24
2020,24,"FC","Tarsalis",40,0,40,54,0.74
2020,24,"LV","Pipiens",0,0,0,6,0
2020,24,"LV","Tarsalis",12,0,12,6,2
2020,24,"NE","Pipiens",2,16,18,10,0.2
2020,24,"NE","Tarsalis",8,0,8,10,0.8
2020,24,"NW","Pipiens",8,4,12,9,0.89
2020,24,"NW","Tarsalis",6,0,6,9,0.67
2020,24,"SE","Pipiens",2,33,35,15,0.13
2020,24,"SE","Tarsalis",2,0,2,15,0.13
2020,24,"SW","Pipiens",0,5,5,9,0
2020,24,"SW","Tarsalis",10,0,10,9,1.11
2020,25,"BE","Pipiens",0,0,0,6,0
2020,25,"BE","Tarsalis",11,0,11,6,1.83
2020,25,"FC","Pipiens",32,149,181,55,0.58
2020,25,"FC","Tarsalis",230,0,230,55,4.18
2020,25,"LV","Pipiens",6,0,6,6,1
2020,25,"LV","Tarsalis",38,0,38,6,6.33
2020,25,"NE","Pipiens",10,29,39,10,1
2020,25,"NE","Tarsalis",35,0,35,10,3.5
2020,25,"NW","Pipiens",1,28,29,9,0.11
2020,25,"NW","Tarsalis",20,0,20,9,2.22
2020,25,"SE","Pipiens",7,91,98,15,0.47
2020,25,"SE","Tarsalis",105,0,105,15,7
2020,25,"SW","Pipiens",8,1,9,9,0.89
2020,25,"SW","Tarsalis",21,0,21,9,2.33
2020,26,"BE","Pipiens",3,0,3,5,0.6
2020,26,"BE","Tarsalis",7,0,7,5,1.4
2020,26,"FC","Pipiens",50,270,320,54,0.93
2020,26,"FC","Tarsalis",388,0,388,54,7.19
2020,26,"LV","Pipiens",3,0,3,6,0.5
2020,26,"LV","Tarsalis",90,0,90,6,15
2020,26,"NE","Pipiens",9,20,29,10,0.9
2020,26,"NE","Tarsalis",38,0,38,10,3.8
2020,26,"NW","Pipiens",8,12,20,9,0.89
2020,26,"NW","Tarsalis",10,0,10,9,1.11
2020,26,"SE","Pipiens",15,231,246,15,1
2020,26,"SE","Tarsalis",211,0,211,15,14.07
2020,26,"SW","Pipiens",12,7,19,9,1.33
2020,26,"SW","Tarsalis",32,0,32,9,3.56
2020,27,"BE","Pipiens",6,0,6,5,1.2
2020,27,"BE","Tarsalis",43,0,43,5,8.6
2020,27,"FC","Pipiens",106,194,300,54,1.96
2020,27,"FC","Tarsalis",719,1,720,54,13.31
2020,27,"LV","Pipiens",8,0,8,6,1.33
2020,27,"LV","Tarsalis",162,0,162,6,27
2020,27,"NE","Pipiens",11,48,59,10,1.1
2020,27,"NE","Tarsalis",89,1,90,10,8.9
2020,27,"NW","Pipiens",36,28,64,9,4
2020,27,"NW","Tarsalis",21,0,21,9,2.33
2020,27,"SE","Pipiens",25,103,128,15,1.67
2020,27,"SE","Tarsalis",322,0,322,15,21.47
2020,27,"SW","Pipiens",20,15,35,9,2.22
2020,27,"SW","Tarsalis",82,0,82,9,9.11
2020,28,"BE","Pipiens",1,0,1,5,0.2
2020,28,"BE","Tarsalis",26,0,26,5,5.2
2020,28,"FC","Pipiens",118,1159,1277,54,2.19
2020,28,"FC","Tarsalis",1140,0,1140,54,21.11
2020,28,"LV","Pipiens",13,0,13,6,2.17
2020,28,"LV","Tarsalis",404,0,404,6,67.33
2020,28,"NE","Pipiens",34,56,90,10,3.4
2020,28,"NE","Tarsalis",218,0,218,10,21.8
2020,28,"NW","Pipiens",27,193,220,9,3
2020,28,"NW","Tarsalis",88,0,88,9,9.78
2020,28,"SE","Pipiens",29,880,909,15,1.93
2020,28,"SE","Tarsalis",263,0,263,15,17.53
2020,28,"SW","Pipiens",14,30,44,9,1.56
2020,28,"SW","Tarsalis",141,0,141,9,15.67
2020,29,"BE","Pipiens",6,0,6,6,1
2020,29,"BE","Tarsalis",17,0,17,6,2.83
2020,29,"FC","Pipiens",143,502,645,55,2.6
2020,29,"FC","Tarsalis",891,0,891,55,16.2
2020,29,"LV","Pipiens",16,0,16,6,2.67
2020,29,"LV","Tarsalis",208,0,208,6,34.67
2020,29,"NE","Pipiens",35,304,339,10,3.5
2020,29,"NE","Tarsalis",307,0,307,10,30.7
2020,29,"NW","Pipiens",31,108,139,9,3.44
2020,29,"NW","Tarsalis",44,0,44,9,4.89
2020,29,"SE","Pipiens",34,56,90,15,2.27
2020,29,"SE","Tarsalis",236,0,236,15,15.73
2020,29,"SW","Pipiens",21,34,55,9,2.33
2020,29,"SW","Tarsalis",79,0,79,9,8.78
2020,30,"BE","Pipiens",7,0,7,6,1.17
2020,30,"BE","Tarsalis",25,0,25,6,4.17
2020,30,"FC","Pipiens",162,526,688,55,2.95
2020,30,"FC","Tarsalis",1540,1,1541,55,28
2020,30,"LV","Pipiens",10,0,10,6,1.67
2020,30,"LV","Tarsalis",201,0,201,6,33.5
2020,30,"NE","Pipiens",26,232,258,10,2.6
2020,30,"NE","Tarsalis",316,1,317,10,31.6
2020,30,"NW","Pipiens",34,43,77,9,3.78
2020,30,"NW","Tarsalis",186,0,186,9,20.67
2020,30,"SE","Pipiens",51,103,154,15,3.4
2020,30,"SE","Tarsalis",614,0,614,15,40.93
2020,30,"SW","Pipiens",34,148,182,9,3.78
2020,30,"SW","Tarsalis",198,0,198,9,22
2020,31,"BE","Pipiens",1,0,1,6,0.17
2020,31,"BE","Tarsalis",42,0,42,6,7
2020,31,"FC","Pipiens",436,890,1326,55,7.93
2020,31,"FC","Tarsalis",1782,0,1782,55,32.4
2020,31,"LV","Pipiens",13,0,13,6,2.17
2020,31,"LV","Tarsalis",553,0,553,6,92.17
2020,31,"NE","Pipiens",85,244,329,10,8.5
2020,31,"NE","Tarsalis",235,0,235,10,23.5
2020,31,"NW","Pipiens",82,92,174,9,9.11
2020,31,"NW","Tarsalis",93,0,93,9,10.33
2020,31,"SE","Pipiens",225,409,634,15,15
2020,31,"SE","Tarsalis",713,0,713,15,47.53
2020,31,"SW","Pipiens",30,145,175,9,3.33
2020,31,"SW","Tarsalis",146,0,146,9,16.22
2020,32,"BE","Pipiens",15,0,15,5,3
2020,32,"BE","Tarsalis",42,0,42,5,8.4
2020,32,"FC","Pipiens",550,704,1254,54,10.19
2020,32,"FC","Tarsalis",1284,0,1284,54,23.78
2020,32,"LV","Pipiens",8,0,8,6,1.33
2020,32,"LV","Tarsalis",81,0,81,6,13.5
2020,32,"NE","Pipiens",181,145,326,10,18.1
2020,32,"NE","Tarsalis",379,0,379,10,37.9
2020,32,"NW","Pipiens",64,77,141,9,7.11
2020,32,"NW","Tarsalis",130,0,130,9,14.44
2020,32,"SE","Pipiens",216,433,649,15,14.4
2020,32,"SE","Tarsalis",514,0,514,15,34.27
2020,32,"SW","Pipiens",66,49,115,9,7.33
2020,32,"SW","Tarsalis",138,0,138,9,15.33
2020,33,"BE","Pipiens",2,0,2,5,0.4
2020,33,"BE","Tarsalis",51,0,51,5,10.2
2020,33,"FC","Pipiens",673,828,1501,54,12.46
2020,33,"FC","Tarsalis",1416,0,1416,54,26.22
2020,33,"LV","Pipiens",14,0,14,6,2.33
2020,33,"LV","Tarsalis",257,0,257,6,42.83
2020,33,"NE","Pipiens",114,163,277,10,11.4
2020,33,"NE","Tarsalis",532,0,532,10,53.2
2020,33,"NW","Pipiens",71,103,174,9,7.89
2020,33,"NW","Tarsalis",134,0,134,9,14.89
2020,33,"SE","Pipiens",402,562,964,15,26.8
2020,33,"SE","Tarsalis",336,0,336,15,22.4
2020,33,"SW","Pipiens",70,0,70,9,7.78
2020,33,"SW","Tarsalis",106,0,106,9,11.78
2020,34,"BE","Pipiens",6,0,6,5,1.2
2020,34,"BE","Tarsalis",52,0,52,5,10.4
2020,34,"FC","Pipiens",650,1100,1750,54,12.04
2020,34,"FC","Tarsalis",1161,0,1161,54,21.5
2020,34,"LV","Pipiens",3,0,3,6,0.5
2020,34,"LV","Tarsalis",175,0,175,6,29.17
2020,34,"NE","Pipiens",174,223,397,10,17.4
2020,34,"NE","Tarsalis",381,0,381,10,38.1
2020,34,"NW","Pipiens",85,313,398,9,9.44
2020,34,"NW","Tarsalis",123,0,123,9,13.67
2020,34,"SE","Pipiens",316,465,781,15,21.07
2020,34,"SE","Tarsalis",381,0,381,15,25.4
2020,34,"SW","Pipiens",66,99,165,9,7.33
2020,34,"SW","Tarsalis",49,0,49,9,5.44
2020,35,"BE","Pipiens",5,0,5,5,1
2020,35,"BE","Tarsalis",32,0,32,5,6.4
2020,35,"FC","Pipiens",618,681,1299,54,11.44
2020,35,"FC","Tarsalis",547,0,547,54,10.13
2020,35,"LV","Pipiens",7,0,7,6,1.17
2020,35,"LV","Tarsalis",82,0,82,6,13.67
2020,35,"NE","Pipiens",246,228,474,10,24.6
2020,35,"NE","Tarsalis",177,0,177,10,17.7
2020,35,"NW","Pipiens",131,80,211,9,14.56
2020,35,"NW","Tarsalis",36,0,36,9,4
2020,35,"SE","Pipiens",209,326,535,15,13.93
2020,35,"SE","Tarsalis",212,0,212,15,14.13
2020,35,"SW","Pipiens",20,47,67,9,2.22
2020,35,"SW","Tarsalis",8,0,8,9,0.89
2020,36,"FC","Pipiens",119,190,309,49,2.43
2020,36,"FC","Tarsalis",89,0,89,49,1.82
2020,36,"LV","Pipiens",33,0,33,6,5.5
2020,36,"LV","Tarsalis",21,0,21,6,3.5
2020,36,"NE","Pipiens",4,53,57,10,0.4
2020,36,"NE","Tarsalis",8,0,8,10,0.8
2020,36,"NW","Pipiens",36,49,85,9,4
2020,36,"NW","Tarsalis",34,0,34,9,3.78
2020,36,"SE","Pipiens",31,57,88,15,2.07
2020,36,"SE","Tarsalis",20,0,20,15,1.33
2020,36,"SW","Pipiens",15,31,46,9,1.67
2020,36,"SW","Tarsalis",6,0,6,9,0.67
2021,23,"BE","Pipiens",1,0,1,5,0.2
2021,23,"BE","Tarsalis",76,0,76,5,15.2
2021,23,"FC","Pipiens",2,0,2,11,0.18
2021,23,"FC","Tarsalis",193,0,193,11,17.55
2021,23,"LV","Pipiens",1,0,1,6,0.17
2021,23,"LV","Tarsalis",117,0,117,6,19.5
2021,24,"BC","Pipiens",0,0,0,4,0
2021,24,"BC","Tarsalis",81,0,81,4,20.25
2021,24,"BE","Pipiens",1,0,1,5,0.2
2021,24,"BE","Tarsalis",223,0,223,5,44.6
2021,24,"FC","Pipiens",1,0,1,15,0.07
2021,24,"FC","Tarsalis",559,0,559,15,37.27
2021,24,"LV","Pipiens",0,0,0,6,0
2021,24,"LV","Tarsalis",255,0,255,6,42.5
2021,25,"BC","Pipiens",0,0,0,6,0
2021,25,"BC","Tarsalis",87,0,87,6,14.5
2021,25,"BE","Pipiens",3,0,3,5,0.6
2021,25,"BE","Tarsalis",188,0,188,5,37.6
2021,25,"FC","Pipiens",71,196,267,60,1.18
2021,25,"FC","Tarsalis",1504,1,1505,60,25.07
2021,25,"LV","Pipiens",12,0,12,6,2
2021,25,"LV","Tarsalis",522,0,522,6,87
2021,25,"NE","Pipiens",12,24,36,10,1.2
2021,25,"NE","Tarsalis",105,0,105,10,10.5
2021,25,"NW","Pipiens",12,52,64,9,1.33
2021,25,"NW","Tarsalis",47,0,47,9,5.22
2021,25,"SE","Pipiens",31,84,115,15,2.07
2021,25,"SE","Tarsalis",502,1,503,15,33.47
2021,25,"SW","Pipiens",1,36,37,9,0.11
2021,25,"SW","Tarsalis",53,0,53,9,5.89
2021,26,"BC","Pipiens",0,0,0,5,0
2021,26,"BC","Tarsalis",26,0,26,5,5.2
2021,26,"BE","Pipiens",12,0,12,5,2.4
2021,26,"BE","Tarsalis",182,0,182,5,36.4
2021,26,"FC","Pipiens",267,180,447,59,4.53
2021,26,"FC","Tarsalis",2311,1,2312,59,39.17
2021,26,"LV","Pipiens",49,0,49,6,8.17
2021,26,"LV","Tarsalis",1064,0,1064,6,177.33
2021,26,"NE","Pipiens",49,21,70,10,4.9
2021,26,"NE","Tarsalis",417,1,418,10,41.7
2021,26,"NW","Pipiens",81,40,121,9,9
2021,26,"NW","Tarsalis",197,0,197,9,21.89
2021,26,"SE","Pipiens",62,94,156,15,4.13
2021,26,"SE","Tarsalis",315,0,315,15,21
2021,26,"SW","Pipiens",14,25,39,9,1.56
2021,26,"SW","Tarsalis",110,0,110,9,12.22
2021,27,"BC","Pipiens",0,0,0,5,0
2021,27,"BC","Tarsalis",155,0,155,5,31
2021,27,"BE","Pipiens",46,0,46,5,9.2
2021,27,"BE","Tarsalis",618,0,618,5,123.6
2021,27,"FC","Pipiens",385,493,878,59,6.53
2021,27,"FC","Tarsalis",5597,0,5597,59,94.86
2021,27,"LV","Pipiens",29,0,29,6,4.83
2021,27,"LV","Tarsalis",2269,0,2269,6,378.17
2021,27,"NE","Pipiens",95,54,149,10,9.5
2021,27,"NE","Tarsalis",1026,0,1026,10,102.6
2021,27,"NW","Pipiens",132,197,329,9,14.67
2021,27,"NW","Tarsalis",549,0,549,9,61
2021,27,"SE","Pipiens",43,228,271,15,2.87
2021,27,"SE","Tarsalis",737,0,737,15,49.13
2021,27,"SW","Pipiens",40,14,54,9,4.44
2021,27,"SW","Tarsalis",243,0,243,9,27
2021,28,"BC","Pipiens",0,0,0,5,0
2021,28,"BC","Tarsalis",127,0,127,5,25.4
2021,28,"BE","Pipiens",79,0,79,5,15.8
2021,28,"BE","Tarsalis",650,0,650,5,130
2021,28,"FC","Pipiens",504,600,1104,59,8.54
2021,28,"FC","Tarsalis",7876,0,7876,59,133.49
2021,28,"LV","Pipiens",67,0,67,6,11.17
2021,28,"LV","Tarsalis",2789,0,2789,6,464.83
2021,28,"NE","Pipiens",99,122,221,10,9.9
2021,28,"NE","Tarsalis",1218,0,1218,10,121.8
2021,28,"NW","Pipiens",38,188,226,9,4.22
2021,28,"NW","Tarsalis",376,0,376,9,41.78
2021,28,"SE","Pipiens",197,271,468,15,13.13
2021,28,"SE","Tarsalis",2434,0,2434,15,162.27
2021,28,"SW","Pipiens",24,19,43,9,2.67
2021,28,"SW","Tarsalis",282,0,282,9,31.33
2021,29,"BC","Pipiens",0,0,0,5,0
2021,29,"BC","Tarsalis",176,0,176,5,35.2
2021,29,"BE","Pipiens",22,0,22,5,4.4
2021,29,"BE","Tarsalis",492,0,492,5,98.4
2021,29,"FC","Pipiens",781,546,1327,59,13.24
2021,29,"FC","Tarsalis",5635,22,5657,59,95.51
2021,29,"LV","Pipiens",69,0,69,6,11.5
2021,29,"LV","Tarsalis",1162,0,1162,6,193.67
2021,29,"NE","Pipiens",323,195,518,10,32.3
2021,29,"NE","Tarsalis",1145,21,1166,10,114.5
2021,29,"NW","Pipiens",46,13,59,9,5.11
2021,29,"NW","Tarsalis",622,0,622,9,69.11
2021,29,"SE","Pipiens",303,197,500,15,20.2
2021,29,"SE","Tarsalis",1938,0,1938,15,129.2
2021,29,"SW","Pipiens",18,141,159,9,2
2021,29,"SW","Tarsalis",100,1,101,9,11.11
2021,30,"BC","Pipiens",0,0,0,5,0
2021,30,"BC","Tarsalis",254,0,254,5,50.8
2021,30,"BE","Pipiens",107,0,107,5,21.4
2021,30,"BE","Tarsalis",993,0,993,5,198.6
2021,30,"FC","Pipiens",1101,1140,2241,59,18.66
2021,30,"FC","Tarsalis",7171,5,7176,59,121.54
2021,30,"LV","Pipiens",27,0,27,6,4.5
2021,30,"LV","Tarsalis",849,0,849,6,141.5
2021,30,"NE","Pipiens",341,278,619,10,34.1
2021,30,"NE","Tarsalis",1191,4,1195,10,119.1
2021,30,"NW","Pipiens",119,190,309,9,13.22
2021,30,"NW","Tarsalis",609,1,610,9,67.67
2021,30,"SE","Pipiens",447,557,1004,15,29.8
2021,30,"SE","Tarsalis",2712,0,2712,15,180.8
2021,30,"SW","Pipiens",60,115,175,9,6.67
2021,30,"SW","Tarsalis",563,0,563,9,62.56
2021,31,"BC","Pipiens",0,0,0,5,0
2021,31,"BC","Tarsalis",237,0,237,5,47.4
2021,31,"BE","Pipiens",60,0,60,5,12
2021,31,"BE","Tarsalis",160,0,160,5,32
2021,31,"FC","Pipiens",1323,703,2026,59,22.42
2021,31,"FC","Tarsalis",3190,2,3192,59,54.07
2021,31,"LV","Pipiens",78,0,78,6,13
2021,31,"LV","Tarsalis",576,0,576,6,96
2021,31,"NE","Pipiens",833,83,916,10,83.3
2021,31,"NE","Tarsalis",993,0,993,10,99.3
2021,31,"NW","Pipiens",60,10,70,9,6.67
2021,31,"NW","Tarsalis",100,0,100,9,11.11
2021,31,"SE","Pipiens",240,201,441,15,16
2021,31,"SE","Tarsalis",1011,2,1013,15,67.4
2021,31,"SW","Pipiens",52,409,461,9,5.78
2021,31,"SW","Tarsalis",113,0,113,9,12.56
2021,32,"BC","Pipiens",0,0,0,5,0
2021,32,"BC","Tarsalis",132,0,132,5,26.4
2021,32,"BE","Pipiens",78,0,78,5,15.6
2021,32,"BE","Tarsalis",140,0,140,5,28
2021,32,"FC","Pipiens",1497,814,2311,59,25.37
2021,32,"FC","Tarsalis",1746,8,1754,59,29.59
2021,32,"LV","Pipiens",53,0,53,6,8.83
2021,32,"LV","Tarsalis",411,0,411,6,68.5
2021,32,"NE","Pipiens",911,229,1140,10,91.1
2021,32,"NE","Tarsalis",447,6,453,10,44.7
2021,32,"NW","Pipiens",102,112,214,9,11.33
2021,32,"NW","Tarsalis",95,0,95,9,10.56
2021,32,"SE","Pipiens",294,211,505,15,19.6
2021,32,"SE","Tarsalis",447,2,449,15,29.8
2021,32,"SW","Pipiens",59,262,321,9,6.56
2021,32,"SW","Tarsalis",74,0,74,9,8.22
2021,33,"BC","Pipiens",0,0,0,5,0
2021,33,"BC","Tarsalis",103,0,103,5,20.6
2021,33,"BE","Pipiens",29,0,29,5,5.8
2021,33,"BE","Tarsalis",132,0,132,5,26.4
2021,33,"FC","Pipiens",413,1023,1436,59,7
2021,33,"FC","Tarsalis",1051,3,1054,59,17.81
2021,33,"LV","Pipiens",112,0,112,6,18.67
2021,33,"LV","Tarsalis",291,0,291,6,48.5
2021,33,"NE","Pipiens",130,69,199,10,13
2021,33,"NE","Tarsalis",257,1,258,10,25.7
2021,33,"NW","Pipiens",44,204,248,9,4.89
2021,33,"NW","Tarsalis",129,2,131,9,14.33
2021,33,"SE","Pipiens",68,429,497,15,4.53
2021,33,"SE","Tarsalis",95,0,95,15,6.33
2021,33,"SW","Pipiens",30,321,351,9,3.33
2021,33,"SW","Tarsalis",44,0,44,9,4.89
2021,34,"BC","Pipiens",0,0,0,5,0
2021,34,"BC","Tarsalis",73,0,73,5,14.6
2021,34,"BE","Pipiens",28,0,28,5,5.6
2021,34,"BE","Tarsalis",112,0,112,5,22.4
2021,34,"FC","Pipiens",949,490,1439,59,16.08
2021,34,"FC","Tarsalis",533,0,533,59,9.03
2021,34,"LV","Pipiens",72,0,72,6,12
2021,34,"LV","Tarsalis",147,0,147,6,24.5
2021,34,"NE","Pipiens",680,138,818,10,68
2021,34,"NE","Tarsalis",81,0,81,10,8.1
2021,34,"NW","Pipiens",24,139,163,9,2.67
2021,34,"NW","Tarsalis",36,0,36,9,4
2021,34,"SE","Pipiens",126,188,314,15,8.4
2021,34,"SE","Tarsalis",67,0,67,15,4.47
2021,34,"SW","Pipiens",19,25,44,9,2.11
2021,34,"SW","Tarsalis",17,0,17,9,1.89
2021,35,"BC","Pipiens",0,0,0,5,0
2021,35,"BC","Tarsalis",28,0,28,5,5.6
2021,35,"BE","Pipiens",34,0,34,5,6.8
2021,35,"BE","Tarsalis",44,0,44,5,8.8
2021,35,"FC","Pipiens",751,307,1058,59,12.73
2021,35,"FC","Tarsalis",333,0,333,59,5.64
2021,35,"LV","Pipiens",44,0,44,6,7.33
2021,35,"LV","Tarsalis",75,0,75,6,12.5
2021,35,"NE","Pipiens",358,42,400,10,35.8
2021,35,"NE","Tarsalis",30,0,30,10,3
2021,35,"NW","Pipiens",22,70,92,9,2.44
2021,35,"NW","Tarsalis",25,0,25,9,2.78
2021,35,"SE","Pipiens",267,156,423,15,17.8
2021,35,"SE","Tarsalis",116,0,116,15,7.73
2021,35,"SW","Pipiens",26,39,65,9,2.89
2021,35,"SW","Tarsalis",15,0,15,9,1.67
2021,36,"BC","Pipiens",0,0,0,5,0
2021,36,"BC","Tarsalis",26,0,26,5,5.2
2021,36,"FC","Pipiens",1039,208,1247,54,19.24
2021,36,"FC","Tarsalis",70,1,71,54,1.3
2021,36,"LV","Pipiens",1,0,1,6,0.17
2021,36,"LV","Tarsalis",8,0,8,6,1.33
2021,36,"NE","Pipiens",665,35,700,10,66.5
2021,36,"NE","Tarsalis",14,1,15,10,1.4
2021,36,"NW","Pipiens",15,52,67,9,1.67
2021,36,"NW","Tarsalis",5,0,5,9,0.56
2021,36,"SE","Pipiens",340,92,432,15,22.67
2021,36,"SE","Tarsalis",10,0,10,15,0.67
2021,36,"SW","Pipiens",18,29,47,9,2
2021,36,"SW","Tarsalis",7,0,7,9,0.78
2022,23,"BE","Pipiens",0,0,0,5,0
2022,23,"BE","Tarsalis",42,0,42,5,8.4
2022,23,"FC","Pipiens",10,69,79,54,0.19
2022,23,"FC","Tarsalis",268,1,269,54,4.96
2022,23,"LV","Pipiens",2,0,2,6,0.33
2022,23,"LV","Tarsalis",51,0,51,6,8.5
2022,23,"NE","Pipiens",0,7,7,10,0
2022,23,"NE","Tarsalis",59,1,60,10,5.9
2022,23,"NW","Pipiens",2,1,3,9,0.22
2022,23,"NW","Tarsalis",14,0,14,9,1.56
2022,23,"SE","Pipiens",4,52,56,15,0.27
2022,23,"SE","Tarsalis",83,0,83,15,5.53
2022,23,"SW","Pipiens",2,9,11,9,0.22
2022,23,"SW","Tarsalis",19,0,19,9,2.11
2022,24,"BC","Pipiens",0,0,0,5,0
2022,24,"BC","Tarsalis",73,0,73,5,14.6
2022,24,"BE","Pipiens",3,0,3,5,0.6
2022,24,"BE","Tarsalis",57,0,57,5,11.4
2022,24,"FC","Pipiens",35,72,107,59,0.59
2022,24,"FC","Tarsalis",549,4,553,59,9.31
2022,24,"LV","Pipiens",3,0,3,6,0.5
2022,24,"LV","Tarsalis",118,0,118,6,19.67
2022,24,"NE","Pipiens",7,23,30,10,0.7
2022,24,"NE","Tarsalis",127,2,129,10,12.7
2022,24,"NW","Pipiens",13,9,22,9,1.44
2022,24,"NW","Tarsalis",69,1,70,9,7.67
2022,24,"SE","Pipiens",4,38,42,15,0.27
2022,24,"SE","Tarsalis",81,1,82,15,5.4
2022,24,"SW","Pipiens",5,2,7,9,0.56
2022,24,"SW","Tarsalis",24,0,24,9,2.67
2022,25,"BC","Pipiens",0,0,0,5,0
2022,25,"BC","Tarsalis",73,0,73,5,14.6
2022,25,"BE","Pipiens",1,0,1,5,0.2
2022,25,"BE","Tarsalis",33,0,33,5,6.6
2022,25,"FC","Pipiens",57,47,104,59,0.97
2022,25,"FC","Tarsalis",535,1,536,59,9.07
2022,25,"LV","Pipiens",0,0,0,6,0
2022,25,"LV","Tarsalis",82,0,82,6,13.67
2022,25,"NE","Pipiens",39,12,51,10,3.9
2022,25,"NE","Tarsalis",171,1,172,10,17.1
2022,25,"NW","Pipiens",7,3,10,9,0.78
2022,25,"NW","Tarsalis",18,0,18,9,2
2022,25,"SE","Pipiens",8,29,37,15,0.53
2022,25,"SE","Tarsalis",138,0,138,15,9.2
2022,25,"SW","Pipiens",2,3,5,9,0.22
2022,25,"SW","Tarsalis",20,0,20,9,2.22
2022,26,"BC","Pipiens",0,0,0,5,0
2022,26,"BC","Tarsalis",82,0,82,5,16.4
2022,26,"BE","Pipiens",11,0,11,5,2.2
2022,26,"BE","Tarsalis",238,0,238,5,47.6
2022,26,"FC","Pipiens",151,106,257,59,2.56
2022,26,"FC","Tarsalis",1127,1,1128,59,19.1
2022,26,"LV","Pipiens",26,0,26,6,4.33
2022,26,"LV","Tarsalis",305,0,305,6,50.83
2022,26,"NE","Pipiens",32,2,34,10,3.2
2022,26,"NE","Tarsalis",85,0,85,10,8.5
2022,26,"NW","Pipiens",31,41,72,9,3.44
2022,26,"NW","Tarsalis",34,0,34,9,3.78
2022,26,"SE","Pipiens",50,45,95,15,3.33
2022,26,"SE","Tarsalis",371,1,372,15,24.73
2022,26,"SW","Pipiens",1,18,19,9,0.11
2022,26,"SW","Tarsalis",12,0,12,9,1.33
2022,27,"BC","Pipiens",0,0,0,5,0
2022,27,"BC","Tarsalis",189,0,189,5,37.8
2022,27,"BE","Pipiens",4,0,4,5,0.8
2022,27,"BE","Tarsalis",176,0,176,5,35.2
2022,27,"FC","Pipiens",275,167,442,59,4.66
2022,27,"FC","Tarsalis",2761,1,2762,59,46.8
2022,27,"LV","Pipiens",7,0,7,6,1.17
2022,27,"LV","Tarsalis",451,0,451,6,75.17
2022,27,"NE","Pipiens",195,52,247,10,19.5
2022,27,"NE","Tarsalis",357,0,357,10,35.7
2022,27,"NW","Pipiens",27,22,49,9,3
2022,27,"NW","Tarsalis",72,0,72,9,8
2022,27,"SE","Pipiens",36,82,118,15,2.4
2022,27,"SE","Tarsalis",1405,1,1406,15,93.67
2022,27,"SW","Pipiens",6,11,17,9,0.67
2022,27,"SW","Tarsalis",111,0,111,9,12.33
2022,28,"BC","Pipiens",0,0,0,5,0
2022,28,"BC","Tarsalis",175,0,175,5,35
2022,28,"BE","Pipiens",5,0,5,5,1
2022,28,"BE","Tarsalis",141,0,141,5,28.2
2022,28,"FC","Pipiens",411,251,662,59,6.97
2022,28,"FC","Tarsalis",4948,6,4954,59,83.86
2022,28,"LV","Pipiens",20,0,20,6,3.33
2022,28,"LV","Tarsalis",809,0,809,6,134.83
2022,28,"NE","Pipiens",297,107,404,10,29.7
2022,28,"NE","Tarsalis",1398,2,1400,10,139.8
2022,28,"NW","Pipiens",21,33,54,9,2.33
2022,28,"NW","Tarsalis",445,2,447,9,49.44
2022,28,"SE","Pipiens",59,77,136,15,3.93
2022,28,"SE","Tarsalis",1533,2,1535,15,102.2
2022,28,"SW","Pipiens",9,34,43,9,1
2022,28,"SW","Tarsalis",447,0,447,9,49.67
2022,29,"BC","Pipiens",0,0,0,5,0
2022,29,"BC","Tarsalis",169,0,169,5,33.8
2022,29,"BE","Pipiens",12,0,12,5,2.4
2022,29,"BE","Tarsalis",467,0,467,5,93.4
2022,29,"FC","Pipiens",603,652,1255,59,10.22
2022,29,"FC","Tarsalis",5302,7,5309,59,89.86
2022,29,"LV","Pipiens",48,0,48,6,8
2022,29,"LV","Tarsalis",866,0,866,6,144.33
2022,29,"NE","Pipiens",389,141,530,10,38.9
2022,29,"NE","Tarsalis",1364,0,1364,10,136.4
2022,29,"NW","Pipiens",50,183,233,9,5.56
2022,29,"NW","Tarsalis",427,0,427,9,47.44
2022,29,"SE","Pipiens",69,262,331,15,4.6
2022,29,"SE","Tarsalis",1578,7,1585,15,105.2
2022,29,"SW","Pipiens",35,66,101,9,3.89
2022,29,"SW","Tarsalis",431,0,431,9,47.89
2022,30,"BC","Pipiens",0,0,0,5,0
2022,30,"BC","Tarsalis",145,0,145,5,29
2022,30,"BE","Pipiens",12,0,12,5,2.4
2022,30,"BE","Tarsalis",147,0,147,5,29.4
2022,30,"FC","Pipiens",1162,245,1407,59,19.69
2022,30,"FC","Tarsalis",2593,1,2594,59,43.95
2022,30,"LV","Pipiens",209,0,209,6,34.83
2022,30,"LV","Tarsalis",737,0,737,6,122.83
2022,30,"NE","Pipiens",676,32,708,10,67.6
2022,30,"NE","Tarsalis",479,1,480,10,47.9
2022,30,"NW","Pipiens",61,51,112,9,6.78
2022,30,"NW","Tarsalis",204,0,204,9,22.67
2022,30,"SE","Pipiens",184,102,286,15,12.27
2022,30,"SE","Tarsalis",698,0,698,15,46.53
2022,30,"SW","Pipiens",20,60,80,9,2.22
2022,30,"SW","Tarsalis",183,0,183,9,20.33
2022,31,"BC","Pipiens",0,0,0,5,0
2022,31,"BC","Tarsalis",136,0,136,5,27.2
2022,31,"BE","Pipiens",26,0,26,5,5.2
2022,31,"BE","Tarsalis",293,0,293,5,58.6
2022,31,"FC","Pipiens",976,518,1494,59,16.54
2022,31,"FC","Tarsalis",2879,9,2888,59,48.8
2022,31,"LV","Pipiens",111,0,111,6,18.5
2022,31,"LV","Tarsalis",781,0,781,6,130.17
2022,31,"NE","Pipiens",451,122,573,10,45.1
2022,31,"NE","Tarsalis",633,6,639,10,63.3
2022,31,"NW","Pipiens",63,27,90,9,7
2022,31,"NW","Tarsalis",284,0,284,9,31.56
2022,31,"SE","Pipiens",268,227,495,15,17.87
2022,31,"SE","Tarsalis",550,3,553,15,36.67
2022,31,"SW","Pipiens",57,142,199,9,6.33
2022,31,"SW","Tarsalis",202,0,202,9,22.44
2022,32,"BC","Pipiens",0,0,0,5,0
2022,32,"BC","Tarsalis",91,0,91,5,18.2
2022,32,"BE","Pipiens",55,0,55,5,11
2022,32,"BE","Tarsalis",486,0,486,5,97.2
2022,32,"FC","Pipiens",1972,170,2142,59,33.42
2022,32,"FC","Tarsalis",2924,0,2924,59,49.56
2022,32,"LV","Pipiens",127,0,127,6,21.17
2022,32,"LV","Tarsalis",417,0,417,6,69.5
2022,32,"NE","Pipiens",1324,11,1335,10,132.4
2022,32,"NE","Tarsalis",405,0,405,10,40.5
2022,32,"NW","Pipiens",55,47,102,9,6.11
2022,32,"NW","Tarsalis",233,0,233,9,25.89
2022,32,"SE","Pipiens",300,66,366,15,20
2022,32,"SE","Tarsalis",688,0,688,15,45.87
2022,32,"SW","Pipiens",111,46,157,9,12.33
2022,32,"SW","Tarsalis",604,0,604,9,67.11
2022,33,"BC","Pipiens",0,0,0,5,0
2022,33,"BC","Tarsalis",38,0,38,5,7.6
2022,33,"BE","Pipiens",39,0,39,5,7.8
2022,33,"BE","Tarsalis",110,0,110,5,22
2022,33,"FC","Pipiens",1936,257,2193,59,32.81
2022,33,"FC","Tarsalis",2203,9,2212,59,37.34
2022,33,"LV","Pipiens",106,0,106,6,17.67
2022,33,"LV","Tarsalis",137,0,137,6,22.83
2022,33,"NE","Pipiens",955,149,1104,10,95.5
2022,33,"NE","Tarsalis",787,8,795,10,78.7
2022,33,"NW","Pipiens",100,15,115,9,11.11
2022,33,"NW","Tarsalis",156,0,156,9,17.33
2022,33,"SE","Pipiens",636,53,689,15,42.4
2022,33,"SE","Tarsalis",734,1,735,15,48.93
2022,33,"SW","Pipiens",100,40,140,9,11.11
2022,33,"SW","Tarsalis",241,0,241,9,26.78
2022,34,"BC","Pipiens",0,0,0,5,0
2022,34,"BC","Tarsalis",36,0,36,5,7.2
2022,34,"BE","Pipiens",43,0,43,5,8.6
2022,34,"BE","Tarsalis",145,0,145,5,29
2022,34,"FC","Pipiens",2438,751,3189,59,41.32
2022,34,"FC","Tarsalis",2486,3,2489,59,42.14
2022,34,"LV","Pipiens",227,0,227,6,37.83
2022,34,"LV","Tarsalis",429,0,429,6,71.5
2022,34,"NE","Pipiens",1480,119,1599,10,148
2022,34,"NE","Tarsalis",732,3,735,10,73.2
2022,34,"NW","Pipiens",140,69,209,9,15.56
2022,34,"NW","Tarsalis",420,0,420,9,46.67
2022,34,"SE","Pipiens",407,273,680,15,27.13
2022,34,"SE","Tarsalis",463,0,463,15,30.87
2022,34,"SW","Pipiens",141,290,431,9,15.67
2022,34,"SW","Tarsalis",261,0,261,9,29
2022,35,"BC","Pipiens",23,0,23,4,5.75
2022,35,"BC","Tarsalis",10,0,10,4,2.5
2022,35,"BE","Pipiens",51,0,51,5,10.2
2022,35,"BE","Tarsalis",113,0,113,5,22.6
2022,35,"FC","Pipiens",1053,455,1508,58,18.16
2022,35,"FC","Tarsalis",880,2,882,58,15.17
2022,35,"LV","Pipiens",80,0,80,6,13.33
2022,35,"LV","Tarsalis",188,0,188,6,31.33
2022,35,"NE","Pipiens",302,123,425,10,30.2
2022,35,"NE","Tarsalis",110,1,111,10,11
2022,35,"NW","Pipiens",65,41,106,9,7.22
2022,35,"NW","Tarsalis",96,1,97,9,10.67
2022,35,"SE","Pipiens",460,187,647,15,30.67
2022,35,"SE","Tarsalis",264,0,264,15,17.6
2022,35,"SW","Pipiens",72,104,176,9,8
2022,35,"SW","Tarsalis",99,0,99,9,11
2022,36,"BC","Pipiens",7,0,7,4,1.75
2022,36,"BC","Tarsalis",13,0,13,4,3.25
2022,36,"FC","Pipiens",942,228,1170,53,17.77
2022,36,"FC","Tarsalis",315,6,321,53,5.94
2022,36,"LV","Pipiens",96,0,96,6,16
2022,36,"LV","Tarsalis",76,0,76,6,12.67
2022,36,"NE","Pipiens",482,91,573,10,48.2
2022,36,"NE","Tarsalis",121,4,125,10,12.1
2022,36,"NW","Pipiens",31,28,59,9,3.44
2022,36,"NW","Tarsalis",25,1,26,9,2.78
2022,36,"SE","Pipiens",314,83,397,15,20.93
2022,36,"SE","Tarsalis",60,1,61,15,4
2022,36,"SW","Pipiens",12,26,38,9,1.33
2022,36,"SW","Tarsalis",20,0,20,9,2.22
2022,37,"BC","Pipiens",10,0,10,4,2.5
2022,37,"BC","Tarsalis",14,0,14,4,3.5
2022,37,"FC","Pipiens",1618,192,1810,47,34.43
2022,37,"FC","Tarsalis",154,2,156,47,3.28
2022,37,"NE","Pipiens",1157,121,1278,10,115.7
2022,37,"NE","Tarsalis",49,2,51,10,4.9
2022,37,"NW","Pipiens",31,6,37,9,3.44
2022,37,"NW","Tarsalis",11,0,11,9,1.22
2022,37,"SE","Pipiens",395,39,434,15,26.33
2022,37,"SE","Tarsalis",39,0,39,15,2.6
2022,37,"SW","Pipiens",25,26,51,9,2.78
2022,37,"SW","Tarsalis",41,0,41,9,4.56
2023,23,"BE","Pipiens",0,0,0,5,0
2023,23,"BE","Tarsalis",64,0,64,5,12.8
2023,23,"FC","Pipiens",51,21,72,54,0.94
2023,23,"FC","Tarsalis",384,3,387,54,7.11
2023,23,"LV","Pipiens",5,0,5,6,0.83
2023,23,"LV","Tarsalis",152,0,152,6,25.33
2023,23,"NE","Pipiens",3,6,9,10,0.3
2023,23,"NE","Tarsalis",7,2,9,10,0.7
2023,23,"NW","Pipiens",15,2,17,9,1.67
2023,23,"NW","Tarsalis",37,0,37,9,4.11
2023,23,"SE","Pipiens",12,11,23,15,0.8
2023,23,"SE","Tarsalis",73,1,74,15,4.87
2023,23,"SW","Pipiens",16,2,18,9,1.78
2023,23,"SW","Tarsalis",51,0,51,9,5.67
2023,24,"BE","Pipiens",4,0,4,5,0.8
2023,24,"BE","Tarsalis",54,0,54,5,10.8
2023,24,"FC","Pipiens",69,70,139,54,1.28
2023,24,"FC","Tarsalis",441,0,441,54,8.17
2023,24,"LV","Pipiens",7,0,7,6,1.17
2023,24,"LV","Tarsalis",185,0,185,6,30.83
2023,24,"NE","Pipiens",7,0,7,10,0.7
2023,24,"NE","Tarsalis",20,0,20,10,2
2023,24,"NW","Pipiens",18,2,20,9,2
2023,24,"NW","Tarsalis",20,0,20,9,2.22
2023,24,"SE","Pipiens",22,41,63,15,1.47
2023,24,"SE","Tarsalis",113,0,113,15,7.53
2023,24,"SW","Pipiens",11,27,38,9,1.22
2023,24,"SW","Tarsalis",49,0,49,9,5.44
2023,25,"BC","Pipiens",0,0,0,5,0
2023,25,"BC","Tarsalis",120,0,120,5,24
2023,25,"BE","Pipiens",7,0,7,5,1.4
2023,25,"BE","Tarsalis",483,0,483,5,96.6
2023,25,"FC","Pipiens",116,81,197,59,1.97
2023,25,"FC","Tarsalis",1875,3,1878,59,31.78
2023,25,"LV","Pipiens",10,0,10,6,1.67
2023,25,"LV","Tarsalis",561,0,561,6,93.5
2023,25,"NE","Pipiens",21,7,28,10,2.1
2023,25,"NE","Tarsalis",126,0,126,10,12.6
2023,25,"NW","Pipiens",45,7,52,9,5
2023,25,"NW","Tarsalis",123,0,123,9,13.67
2023,25,"SE","Pipiens",19,66,85,15,1.27
2023,25,"SE","Tarsalis",419,3,422,15,27.93
2023,25,"SW","Pipiens",14,1,15,9,1.56
2023,25,"SW","Tarsalis",43,0,43,9,4.78
2023,26,"BC","Pipiens",0,0,0,5,0
2023,26,"BC","Tarsalis",225,0,225,5,45
2023,26,"BE","Pipiens",5,0,5,5,1
2023,26,"BE","Tarsalis",617,0,617,5,123.4
2023,26,"FC","Pipiens",280,184,464,59,4.75
2023,26,"FC","Tarsalis",8984,7,8991,59,152.27
2023,26,"LV","Pipiens",21,0,21,6,3.5
2023,26,"LV","Tarsalis",1759,0,1759,6,293.17
2023,26,"NE","Pipiens",100,68,168,10,10
2023,26,"NE","Tarsalis",1185,0,1185,10,118.5
2023,26,"NW","Pipiens",28,25,53,9,3.11
2023,26,"NW","Tarsalis",1147,0,1147,9,127.44
2023,26,"SE","Pipiens",80,71,151,15,5.33
2023,26,"SE","Tarsalis",3263,6,3269,15,217.53
2023,26,"SW","Pipiens",46,20,66,9,5.11
2023,26,"SW","Tarsalis",788,1,789,9,87.56
2023,27,"BC","Pipiens",0,0,0,5,0
2023,27,"BC","Tarsalis",343,0,343,5,68.6
2023,27,"BE","Pipiens",6,0,6,5,1.2
2023,27,"BE","Tarsalis",700,0,700,5,140
2023,27,"FC","Pipiens",408,106,514,59,6.92
2023,27,"FC","Tarsalis",11927,7,11934,59,202.15
2023,27,"LV","Pipiens",101,0,101,6,16.83
2023,27,"LV","Tarsalis",3233,0,3233,6,538.83
2023,27,"NE","Pipiens",109,29,138,10,10.9
2023,27,"NE","Tarsalis",1934,6,1940,10,193.4
2023,27,"NW","Pipiens",72,3,75,9,8
2023,27,"NW","Tarsalis",197,0,197,9,21.89
2023,27,"SE","Pipiens",100,69,169,15,6.67
2023,27,"SE","Tarsalis",5319,1,5320,15,354.6
2023,27,"SW","Pipiens",20,5,25,9,2.22
2023,27,"SW","Tarsalis",201,0,201,9,22.33
2023,28,"BC","Pipiens",0,0,0,6,0
2023,28,"BC","Tarsalis",294,0,294,6,49
2023,28,"BE","Pipiens",55,0,55,5,11
2023,28,"BE","Tarsalis",703,0,703,5,140.6
2023,28,"FC","Pipiens",792,379,1171,60,13.2
2023,28,"FC","Tarsalis",12891,9,12900,60,214.85
2023,28,"LV","Pipiens",43,0,43,6,7.17
2023,28,"LV","Tarsalis",807,0,807,6,134.5
2023,28,"NE","Pipiens",222,75,297,10,22.2
2023,28,"NE","Tarsalis",1061,0,1061,10,106.1
2023,28,"NW","Pipiens",123,44,167,9,13.67
2023,28,"NW","Tarsalis",1567,0,1567,9,174.11
2023,28,"SE","Pipiens",298,161,459,15,19.87
2023,28,"SE","Tarsalis",6287,8,6295,15,419.13
2023,28,"SW","Pipiens",51,99,150,9,5.67
2023,28,"SW","Tarsalis",2172,1,2173,9,241.33
2023,29,"BC","Pipiens",49,0,49,5,9.8
2023,29,"BC","Tarsalis",245,0,245,5,49
2023,29,"BE","Pipiens",31,0,31,5,6.2
2023,29,"BE","Tarsalis",722,0,722,5,144.4
2023,29,"FC","Pipiens",794,684,1478,59,13.46
2023,29,"FC","Tarsalis",17445,21,17466,59,295.68
2023,29,"LV","Pipiens",20,0,20,6,3.33
2023,29,"LV","Tarsalis",900,0,900,6,150
2023,29,"NE","Pipiens",265,197,462,10,26.5
2023,29,"NE","Tarsalis",4469,6,4475,10,446.9
2023,29,"NW","Pipiens",158,367,525,9,17.56
2023,29,"NW","Tarsalis",2276,4,2280,9,252.89
2023,29,"SE","Pipiens",134,104,238,15,8.93
2023,29,"SE","Tarsalis",6774,11,6785,15,451.6
2023,29,"SW","Pipiens",137,16,153,9,15.22
2023,29,"SW","Tarsalis",2059,0,2059,9,228.78
2023,30,"BC","Pipiens",0,0,0,6,0
2023,30,"BC","Tarsalis",294,0,294,6,49
2023,30,"BE","Pipiens",24,0,24,5,4.8
2023,30,"BE","Tarsalis",416,0,416,5,83.2
2023,30,"FC","Pipiens",720,328,1048,60,12
2023,30,"FC","Tarsalis",6997,11,7008,60,116.62
2023,30,"LV","Pipiens",18,0,18,6,3
2023,30,"LV","Tarsalis",690,0,690,6,115
2023,30,"NE","Pipiens",504,132,636,10,50.4
2023,30,"NE","Tarsalis",2769,6,2775,10,276.9
2023,30,"NW","Pipiens",62,33,95,9,6.89
2023,30,"NW","Tarsalis",685,0,685,9,76.11
2023,30,"SE","Pipiens",80,113,193,15,5.33
2023,30,"SE","Tarsalis",1264,5,1269,15,84.27
2023,30,"SW","Pipiens",32,50,82,9,3.56
2023,30,"SW","Tarsalis",879,0,879,9,97.67
2023,31,"BC","Pipiens",0,0,0,6,0
2023,31,"BC","Tarsalis",282,0,282,6,47
2023,31,"BE","Pipiens",49,0,49,5,9.8
2023,31,"BE","Tarsalis",210,0,210,5,42
2023,31,"FC","Pipiens",406,366,772,60,6.77
2023,31,"FC","Tarsalis",3706,1,3707,60,61.77
2023,31,"LV","Pipiens",25,0,25,6,4.17
2023,31,"LV","Tarsalis",585,0,585,6,97.5
2023,31,"NE","Pipiens",91,1,92,10,9.1
2023,31,"NE","Tarsalis",179,0,179,10,17.9
2023,31,"NW","Pipiens",31,114,145,9,3.44
2023,31,"NW","Tarsalis",233,1,234,9,25.89
2023,31,"SE","Pipiens",176,218,394,15,11.73
2023,31,"SE","Tarsalis",2032,0,2032,15,135.47
2023,31,"SW","Pipiens",34,33,67,9,3.78
2023,31,"SW","Tarsalis",185,0,185,9,20.56
2023,32,"BC","Pipiens",0,0,0,5,0
2023,32,"BC","Tarsalis",237,0,237,5,47.4
2023,32,"BE","Pipiens",50,0,50,5,10
2023,32,"BE","Tarsalis",540,0,540,5,108
2023,32,"FC","Pipiens",527,410,937,59,8.93
2023,32,"FC","Tarsalis",2260,8,2268,59,38.31
2023,32,"LV","Pipiens",146,0,146,6,24.33
2023,32,"LV","Tarsalis",481,0,481,6,80.17
2023,32,"NE","Pipiens",157,47,204,10,15.7
2023,32,"NE","Tarsalis",210,0,210,10,21
2023,32,"NW","Pipiens",55,66,121,9,6.11
2023,32,"NW","Tarsalis",163,0,163,9,18.11
2023,32,"SE","Pipiens",91,295,386,15,6.07
2023,32,"SE","Tarsalis",470,8,478,15,31.33
2023,32,"SW","Pipiens",28,2,30,9,3.11
2023,32,"SW","Tarsalis",159,0,159,9,17.67
2023,33,"BC","Pipiens",0,0,0,5,0
2023,33,"BC","Tarsalis",181,0,181,5,36.2
2023,33,"BE","Pipiens",80,0,80,5,16
2023,33,"BE","Tarsalis",257,0,257,5,51.4
2023,33,"FC","Pipiens",586,393,979,59,9.93
2023,33,"FC","Tarsalis",1683,2,1685,59,28.53
2023,33,"LV","Pipiens",116,0,116,6,19.33
2023,33,"LV","Tarsalis",500,0,500,6,83.33
2023,33,"NE","Pipiens",199,128,327,10,19.9
2023,33,"NE","Tarsalis",205,1,206,10,20.5
2023,33,"NW","Pipiens",60,82,142,9,6.67
2023,33,"NW","Tarsalis",135,0,135,9,15
2023,33,"SE","Pipiens",34,155,189,15,2.27
2023,33,"SE","Tarsalis",118,1,119,15,7.87
2023,33,"SW","Pipiens",97,28,125,9,10.78
2023,33,"SW","Tarsalis",287,0,287,9,31.89
2023,34,"BC","Pipiens",0,0,0,5,0
2023,34,"BC","Tarsalis",211,0,211,5,42.2
2023,34,"BE","Pipiens",71,0,71,5,14.2
2023,34,"BE","Tarsalis",238,0,238,5,47.6
2023,34,"FC","Pipiens",535,320,855,59,9.07
2023,34,"FC","Tarsalis",1846,5,1851,59,31.29
2023,34,"LV","Pipiens",139,0,139,6,23.17
2023,34,"LV","Tarsalis",344,0,344,6,57.33
2023,34,"NE","Pipiens",67,57,124,10,6.7
2023,34,"NE","Tarsalis",131,2,133,10,13.1
2023,34,"NW","Pipiens",58,158,216,9,6.44
2023,34,"NW","Tarsalis",129,2,131,9,14.33
2023,34,"SE","Pipiens",127,90,217,15,8.47
2023,34,"SE","Tarsalis",585,1,586,15,39
2023,34,"SW","Pipiens",73,15,88,9,8.11
2023,34,"SW","Tarsalis",208,0,208,9,23.11
2023,35,"BC","Pipiens",30,0,30,5,6
2023,35,"BC","Tarsalis",25,0,25,5,5
2023,35,"BE","Pipiens",53,0,53,5,10.6
2023,35,"BE","Tarsalis",75,0,75,5,15
2023,35,"FC","Pipiens",460,261,721,59,7.8
2023,35,"FC","Tarsalis",541,1,542,59,9.17
2023,35,"LV","Pipiens",110,0,110,6,18.33
2023,35,"LV","Tarsalis",242,0,242,6,40.33
2023,35,"NE","Pipiens",164,93,257,10,16.4
2023,35,"NE","Tarsalis",67,1,68,10,6.7
2023,35,"NW","Pipiens",51,82,133,9,5.67
2023,35,"NW","Tarsalis",49,0,49,9,5.44
2023,35,"SE","Pipiens",42,55,97,15,2.8
2023,35,"SE","Tarsalis",48,0,48,15,3.2
2023,35,"SW","Pipiens",10,31,41,9,1.11
2023,35,"SW","Tarsalis",35,0,35,9,3.89
2023,36,"BC","Pipiens",0,0,0,5,0
2023,36,"BC","Tarsalis",13,0,13,5,2.6
2023,36,"FC","Pipiens",369,122,491,54,6.83
2023,36,"FC","Tarsalis",130,0,130,54,2.41
2023,36,"LV","Pipiens",55,0,55,6,9.17
2023,36,"LV","Tarsalis",46,0,46,6,7.67
2023,36,"NE","Pipiens",204,24,228,10,20.4
2023,36,"NE","Tarsalis",22,0,22,10,2.2
2023,36,"NW","Pipiens",4,45,49,9,0.44
2023,36,"NW","Tarsalis",5,0,5,9,0.56
2023,36,"SE","Pipiens",73,52,125,15,4.87
2023,36,"SE","Tarsalis",30,0,30,15,2
2023,36,"SW","Pipiens",33,1,34,9,3.67
2023,36,"SW","Tarsalis",14,0,14,9,1.56
2023,37,"FC","Pipiens",439,85,524,43,10.21
2023,37,"FC","Tarsalis",23,0,23,43,0.53
2023,37,"NE","Pipiens",312,42,354,10,31.2
2023,37,"NE","Tarsalis",11,0,11,10,1.1
2023,37,"NW","Pipiens",14,9,23,9,1.56
2023,37,"NW","Tarsalis",0,0,0,9,0
2023,37,"SE","Pipiens",101,29,130,15,6.73
2023,37,"SE","Tarsalis",8,0,8,15,0.53
2023,37,"SW","Pipiens",12,5,17,9,1.33
2023,37,"SW","Tarsalis",4,0,4,9,0.44
2024,23,"BE","Pipiens",1,0,1,5,0.2
2024,23,"BE","Tarsalis",5,0,5,5,1
2024,23,"FC","Pipiens",14,27,41,53,0.26
2024,23,"FC","Tarsalis",139,1,140,53,2.62
2024,23,"LV","Pipiens",0,0,0,6,0
2024,23,"LV","Tarsalis",53,0,53,6,8.83
2024,23,"NE","Pipiens",5,7,12,10,0.5
2024,23,"NE","Tarsalis",25,1,26,10,2.5
2024,23,"NW","Pipiens",4,5,9,9,0.44
2024,23,"NW","Tarsalis",11,0,11,9,1.22
2024,23,"SE","Pipiens",1,14,15,14,0.07
2024,23,"SE","Tarsalis",24,0,24,14,1.71
2024,23,"SW","Pipiens",3,1,4,9,0.33
2024,23,"SW","Tarsalis",21,0,21,9,2.33
2024,24,"BE","Pipiens",1,0,1,10,0.1
2024,24,"BE","Tarsalis",75,0,75,10,7.5
2024,24,"FC","Pipiens",19,104,123,59,0.32
2024,24,"FC","Tarsalis",168,0,168,59,2.85
2024,24,"LV","Pipiens",1,0,1,6,0.17
2024,24,"LV","Tarsalis",31,0,31,6,5.17
2024,24,"NE","Pipiens",1,9,10,10,0.1
2024,24,"NE","Tarsalis",18,0,18,10,1.8
2024,24,"NW","Pipiens",7,20,27,9,0.78
2024,24,"NW","Tarsalis",8,0,8,9,0.89
2024,24,"SE","Pipiens",4,63,67,15,0.27
2024,24,"SE","Tarsalis",29,0,29,15,1.93
2024,24,"SW","Pipiens",5,12,17,9,0.56
2024,24,"SW","Tarsalis",7,0,7,9,0.78
2024,25,"BE","Pipiens",5,0,5,10,0.5
2024,25,"BE","Tarsalis",165,0,165,10,16.5
2024,25,"FC","Pipiens",45,60,105,57,0.79
2024,25,"FC","Tarsalis",524,3,527,57,9.19
2024,25,"LV","Pipiens",2,0,2,6,0.33
2024,25,"LV","Tarsalis",98,0,98,6,16.33
2024,25,"NE","Pipiens",14,23,37,9,1.56
2024,25,"NE","Tarsalis",120,0,120,9,13.33
2024,25,"NW","Pipiens",18,3,21,8,2.25
2024,25,"NW","Tarsalis",34,0,34,8,4.25
2024,25,"SE","Pipiens",1,31,32,15,0.07
2024,25,"SE","Tarsalis",96,3,99,15,6.4
2024,25,"SW","Pipiens",5,3,8,9,0.56
2024,25,"SW","Tarsalis",11,0,11,9,1.22
2024,26,"BC","Pipiens",0,0,0,5,0
2024,26,"BC","Tarsalis",100,0,100,5,20
2024,26,"BE","Pipiens",19,0,19,10,1.9
2024,26,"BE","Tarsalis",500,0,500,10,50
2024,26,"FC","Pipiens",110,207,317,63,1.75
2024,26,"FC","Tarsalis",1334,5,1339,63,21.17
2024,26,"LV","Pipiens",8,0,8,6,1.33
2024,26,"LV","Tarsalis",198,0,198,6,33
2024,26,"NE","Pipiens",26,109,135,10,2.6
2024,26,"NE","Tarsalis",264,5,269,10,26.4
2024,26,"NW","Pipiens",26,62,88,8,3.25
2024,26,"NW","Tarsalis",42,0,42,8,5.25
2024,26,"SE","Pipiens",22,23,45,15,1.47
2024,26,"SE","Tarsalis",212,0,212,15,14.13
2024,26,"SW","Pipiens",9,13,22,9,1
2024,26,"SW","Tarsalis",18,0,18,9,2
2024,27,"BC","Pipiens",0,0,0,5,0
2024,27,"BC","Tarsalis",123,0,123,5,24.6
2024,27,"BE","Pipiens",35,0,35,10,3.5
2024,27,"BE","Tarsalis",530,0,530,10,53
2024,27,"FC","Pipiens",137,301,438,64,2.14
2024,27,"FC","Tarsalis",1171,1,1172,64,18.3
2024,27,"LV","Pipiens",7,0,7,6,1.17
2024,27,"LV","Tarsalis",183,0,183,6,30.5
2024,27,"NE","Pipiens",36,191,227,10,3.6
2024,27,"NE","Tarsalis",167,1,168,10,16.7
2024,27,"NW","Pipiens",32,26,58,9,3.56
2024,27,"NW","Tarsalis",30,0,30,9,3.33
2024,27,"SE","Pipiens",21,77,98,15,1.4
2024,27,"SE","Tarsalis",127,0,127,15,8.47
2024,27,"SW","Pipiens",6,7,13,9,0.67
2024,27,"SW","Tarsalis",11,0,11,9,1.22
2024,28,"BC","Pipiens",0,0,0,5,0
2024,28,"BC","Tarsalis",225,0,225,5,45
2024,28,"BE","Pipiens",49,0,49,10,4.9
2024,28,"BE","Tarsalis",532,0,532,10,53.2
2024,28,"FC","Pipiens",319,251,570,63,5.06
2024,28,"FC","Tarsalis",1652,1,1653,63,26.22
2024,28,"LV","Pipiens",23,0,23,6,3.83
2024,28,"LV","Tarsalis",283,0,283,6,47.17
2024,28,"NE","Pipiens",60,53,113,10,6
2024,28,"NE","Tarsalis",145,0,145,10,14.5
2024,28,"NW","Pipiens",82,69,151,9,9.11
2024,28,"NW","Tarsalis",96,0,96,9,10.67
2024,28,"SE","Pipiens",82,106,188,15,5.47
2024,28,"SE","Tarsalis",305,1,306,15,20.33
2024,28,"SW","Pipiens",23,23,46,8,2.88
2024,28,"SW","Tarsalis",66,0,66,8,8.25
2024,29,"BC","Pipiens",0,0,0,5,0
2024,29,"BC","Tarsalis",245,0,245,5,49
2024,29,"BE","Pipiens",66,0,66,10,6.6
2024,29,"BE","Tarsalis",1069,0,1069,10,106.9
2024,29,"FC","Pipiens",306,491,797,63,4.86
2024,29,"FC","Tarsalis",2166,5,2171,63,34.38
2024,29,"LV","Pipiens",2,0,2,6,0.33
2024,29,"LV","Tarsalis",127,0,127,6,21.17
2024,29,"NE","Pipiens",67,204,271,9,7.44
2024,29,"NE","Tarsalis",289,1,290,9,32.11
2024,29,"NW","Pipiens",94,87,181,9,10.44
2024,29,"NW","Tarsalis",138,1,139,9,15.33
2024,29,"SE","Pipiens",62,171,233,15,4.13
2024,29,"SE","Tarsalis",269,3,272,15,17.93
2024,29,"SW","Pipiens",15,29,44,9,1.67
2024,29,"SW","Tarsalis",29,0,29,9,3.22
2024,30,"BC","Pipiens",0,0,0,5,0
2024,30,"BC","Tarsalis",245,0,245,5,49
2024,30,"BE","Pipiens",59,0,59,10,5.9
2024,30,"BE","Tarsalis",848,0,848,10,84.8
2024,30,"FC","Pipiens",464,367,831,64,7.25
2024,30,"FC","Tarsalis",1805,2,1807,64,28.2
2024,30,"LV","Pipiens",22,0,22,6,3.67
2024,30,"LV","Tarsalis",314,0,314,6,52.33
2024,30,"NE","Pipiens",49,85,134,10,4.9
2024,30,"NE","Tarsalis",72,2,74,10,7.2
2024,30,"NW","Pipiens",178,116,294,9,19.78
2024,30,"NW","Tarsalis",59,0,59,9,6.56
2024,30,"SE","Pipiens",129,128,257,15,8.6
2024,30,"SE","Tarsalis",235,0,235,15,15.67
2024,30,"SW","Pipiens",27,38,65,9,3
2024,30,"SW","Tarsalis",32,0,32,9,3.56
2024,31,"BC","Pipiens",0,0,0,5,0
2024,31,"BC","Tarsalis",245,0,245,5,49
2024,31,"BE","Pipiens",110,0,110,10,11
2024,31,"BE","Tarsalis",1084,0,1084,10,108.4
2024,31,"FC","Pipiens",352,449,801,64,5.5
2024,31,"FC","Tarsalis",2581,3,2584,64,40.33
2024,31,"LV","Pipiens",14,0,14,6,2.33
2024,31,"LV","Tarsalis",263,0,263,6,43.83
2024,31,"NE","Pipiens",61,112,173,10,6.1
2024,31,"NE","Tarsalis",233,1,234,10,23.3
2024,31,"NW","Pipiens",55,190,245,9,6.11
2024,31,"NW","Tarsalis",123,1,124,9,13.67
2024,31,"SE","Pipiens",88,103,191,15,5.87
2024,31,"SE","Tarsalis",560,1,561,15,37.33
2024,31,"SW","Pipiens",24,44,68,9,2.67
2024,31,"SW","Tarsalis",73,0,73,9,8.11
2024,32,"BC","Pipiens",0,0,0,5,0
2024,32,"BC","Tarsalis",172,0,172,5,34.4
2024,32,"BE","Pipiens",88,0,88,10,8.8
2024,32,"BE","Tarsalis",560,0,560,10,56
2024,32,"FC","Pipiens",463,239,702,62,7.47
2024,32,"FC","Tarsalis",1716,6,1722,62,27.68
2024,32,"LV","Pipiens",16,0,16,6,2.67
2024,32,"LV","Tarsalis",303,0,303,6,50.5
2024,32,"NE","Pipiens",82,60,142,10,8.2
2024,32,"NE","Tarsalis",279,2,281,10,27.9
2024,32,"NW","Pipiens",114,51,165,8,14.25
2024,32,"NW","Tarsalis",124,0,124,8,15.5
2024,32,"SE","Pipiens",123,112,235,15,8.2
2024,32,"SE","Tarsalis",223,4,227,15,14.87
2024,32,"SW","Pipiens",40,16,56,8,5
2024,32,"SW","Tarsalis",55,0,55,8,6.88
2024,33,"BC","Pipiens",0,0,0,5,0
2024,33,"BC","Tarsalis",136,0,136,5,27.2
2024,33,"BE","Pipiens",97,0,97,10,9.7
2024,33,"BE","Tarsalis",376,0,376,10,37.6
2024,33,"FC","Pipiens",339,469,808,64,5.3
2024,33,"FC","Tarsalis",1362,3,1365,64,21.28
2024,33,"LV","Pipiens",31,0,31,6,5.17
2024,33,"LV","Tarsalis",249,0,249,6,41.5
2024,33,"NE","Pipiens",85,127,212,10,8.5
2024,33,"NE","Tarsalis",232,2,234,10,23.2
2024,33,"NW","Pipiens",40,33,73,9,4.44
2024,33,"NW","Tarsalis",57,0,57,9,6.33
2024,33,"SE","Pipiens",69,290,359,15,4.6
2024,33,"SE","Tarsalis",271,1,272,15,18.07
2024,33,"SW","Pipiens",17,19,36,9,1.89
2024,33,"SW","Tarsalis",41,0,41,9,4.56
2024,34,"BC","Pipiens",0,0,0,5,0
2024,34,"BC","Tarsalis",53,0,53,5,10.6
2024,34,"BE","Pipiens",144,0,144,10,14.4
2024,34,"BE","Tarsalis",215,0,215,10,21.5
2024,34,"FC","Pipiens",462,705,1167,63,7.33
2024,34,"FC","Tarsalis",972,2,974,63,15.43
2024,34,"LV","Pipiens",62,0,62,6,10.33
2024,34,"LV","Tarsalis",293,0,293,6,48.83
2024,34,"NE","Pipiens",73,361,434,10,7.3
2024,34,"NE","Tarsalis",160,1,161,10,16
2024,34,"NW","Pipiens",37,114,151,9,4.11
2024,34,"NW","Tarsalis",40,1,41,9,4.44
2024,34,"SE","Pipiens",122,207,329,14,8.71
2024,34,"SE","Tarsalis",163,0,163,14,11.64
2024,34,"SW","Pipiens",24,23,47,9,2.67
2024,34,"SW","Tarsalis",48,0,48,9,5.33
2024,35,"BC","Pipiens",15,0,15,3,5
2024,35,"BC","Tarsalis",20,0,20,3,6.67
2024,35,"BE","Pipiens",52,0,52,10,5.2
2024,35,"BE","Tarsalis",63,0,63,10,6.3
2024,35,"FC","Pipiens",396,393,789,62,6.39
2024,35,"FC","Tarsalis",440,1,441,62,7.1
2024,35,"LV","Pipiens",52,0,52,6,8.67
2024,35,"LV","Tarsalis",81,0,81,6,13.5
2024,35,"NE","Pipiens",70,125,195,10,7
2024,35,"NE","Tarsalis",40,0,40,10,4
2024,35,"NW","Pipiens",61,77,138,9,6.78
2024,35,"NW","Tarsalis",29,1,30,9,3.22
2024,35,"SE","Pipiens",113,161,274,15,7.53
2024,35,"SE","Tarsalis",163,0,163,15,10.87
2024,35,"SW","Pipiens",33,30,63,9,3.67
2024,35,"SW","Tarsalis",44,0,44,9,4.89
2024,36,"BC","Pipiens",12,0,12,4,3
2024,36,"BC","Tarsalis",24,0,24,4,6
2024,36,"FC","Pipiens",267,382,649,47,5.68
2024,36,"FC","Tarsalis",135,1,136,47,2.87
2024,36,"NE","Pipiens",134,166,300,10,13.4
2024,36,"NE","Tarsalis",43,0,43,10,4.3
2024,36,"NW","Pipiens",26,166,192,9,2.89
2024,36,"NW","Tarsalis",7,1,8,9,0.78
2024,36,"SE","Pipiens",81,39,120,15,5.4
2024,36,"SE","Tarsalis",55,0,55,15,3.67
2024,36,"SW","Pipiens",14,11,25,9,1.56
2024,36,"SW","Tarsalis",6,0,6,9,0.67
2024,37,"BC","Pipiens",19,0,19,3,6.33
2024,37,"BC","Tarsalis",5,0,5,3,1.67
2024,37,"FC","Pipiens",212,163,375,46,4.61
2024,37,"FC","Tarsalis",72,0,72,46,1.57
2024,37,"NE","Pipiens",111,46,157,10,11.1
2024,37,"NE","Tarsalis",25,0,25,10,2.5
2024,37,"NW","Pipiens",37,44,81,9,4.11
2024,37,"NW","Tarsalis",5,0,5,9,0.56
2024,37,"SE","Pipiens",39,63,102,15,2.6
2024,37,"SE","Tarsalis",31,0,31,15,2.07
2024,37,"SW","Pipiens",6,10,16,9,0.67
2024,37,"SW","Tarsalis",6,0,6,9,0.67
